phonemized_utterance	processed_gloss
aɪ n oʊ oʊ n oʊ	i know oh no .
ɹ aɪ t ð æ t s ɡ ʊ d	right that's good .
ð æ t d oʊ n t k ʌ m aʊ t	that don't come out .
oʊ l ʊ k w ʌ t aɪ d ɪ d	oh look what i did !
iː t ɪ t ɹ aɪ t	eat it right .
ɑː ɹ w iː ɡ ʊ d	are we good ?
w ʌ t d ɪ d w iː iː t	what did we eat ?
d̠ʒ ʌ s t ɹ aɪ t	just right ?
w ɛ l j uː iː t ɪ t ð ɛ n	well you eat it then .
j uː s eɪ ð ɪ s	you say this .
oʊ ɡ ʊ d ɡ ʊ d	oh good good .
w iː d uː j ɛ h	we do yeah .
h iː d aʊ n ð ɛ ɹ	he down there ?
d oʊ n t d oʊ n t ɡ oʊ	don't don't go .
æ n d aɪ h æ v h ɪ m	and i have him .
ʌ p ð ɛ ɹ	up there ?
w ɛ l ð eɪ aɪ θ ɪ ŋ k	well they i think .
w iː ɡ oʊ d aʊ n	we go down .
j uː j uː d uː ɪ t	you you do it .
n oʊ n aʊ	no now .
ɪ t s ɡ oʊ ɪ ŋ	it's going !
ð æ t s ð ə ɹ aɪ t	that's the right .
j ɛ h ð ɛ ɹ z	yeah there's .
j ɛ h j uː n oʊ b eɪ b i	yeah you know baby ?
w iː w ʌ t	we what ?
n oʊ j uː j uː	no you you .
ɪ ɾ ɪ z ɹ aɪ t	it is right .
ð æ t s n ɑː t	that's not .
ɡ ə n ə ɡ oʊ ɡ ɛ t ɪ t	gonna go get it .
oʊ k eɪ k æ n aɪ s iː ɪ t	okay can i see it ?
aɪ m ɡ ə n ə p ʊ t	i'm gonna put .
w ʌ t d uː j uː w ɔ n t ð ɪ s	what do you want this ?
n oʊ l ɛ t s ɡ oʊ	no let's go .
j uː k æ n h æ v ɪ t n aʊ	you can have it now .
j uː w ɔ n t m iː	you want me ?
d ɪ d aɪ ɡ ɛ t w ʌ n	did i get one ?
ɪ n b ɪ ɡ w ʌ n	in big one .
j uː p l eɪ ɪ n h ɪ ɹ	you play in here .
oʊ aɪ s iː ɐ b eɪ b i	oh i see a baby !
n aʊ ð æ t s ð æ t	now that's that .
h iː d oʊ n t w ɔ n ə iː t n oʊ	he don't wanna eat no .
w ʌ t d uː aɪ	what do i .
k ʌ m ʌ p	come up !
h aʊ d ʌ z ʃ iː n oʊ	how does she know ?
j uː w ɔ n ə ɡ ɛ t h ɪ m	you wanna get him ?
b ʌ t w ɛ ɹ ɪ z	but where is .
f ɔː ɹ j uː t ə ɡ ɛ t t uː	for you to get to ?
w ɛ l k ʌ m ɔ n oʊ v ɚ h ɪ ɹ	well come on over here .
aɪ d oʊ n t n oʊ n ɑː t m iː	i don't know not me .
ɐ l ɪ ɾ ə l w ʌ n j ɛ h	a little one yeah .
d uː j uː θ ɪ ŋ k ʌ m	do you think um ?
f ɔː ɹ j ʊ ɹ w ʌ t	for your what ?
j ɛ h d oʊ n t j uː	yeah don't you ?
j ɛ h n aʊ d aʊ n d aʊ n	yeah now down down .
oʊ w ɛ ɹ ɪ ɾ ɪ z	oh where it is ?
oʊ w ʌ z	oh was .
æ n d w ʌ n æ n d w ʌ n	and one and one .
j ɛ h ɪ z ɪ t ɡ ʊ d	yeah is it good ?
s ʌ m ʌ v ɪ ɾ ɪ z ɡ ʊ d	some of it is good ?
w ɪ ð n oʊ	with no .
j ɛ h w ɛ l w iː d ɪ d ð æ t	yeah well we did that .
j ɛ h j uː s iː	yeah you see ?
oʊ ð ə b eɪ b i	oh the baby ?
h aʊ ɐ b aʊ t d uː	how about do .
oʊ k eɪ h iː k æ n	okay he can .
w ʌ t s ð æ t b eɪ b i	what's that baby ?
j uː d ɪ d l aɪ k ɪ t	you did like it .
aɪ ɡ oʊ aʊ t	i go out .
ɪ f ð eɪ w ɔ n ə iː t	if they wanna eat .
w ɛ l k ʌ m h ɪ ɹ ð ɛ n	well come here then .
j ɛ h s eɪ oʊ k eɪ	yeah say okay !
l ʊ k æ t ð ə b eɪ b i	look at the baby !
j uː w ɔ n ə h æ v w ʌ n	you wanna have one ?
d aʊ n h ɪ ɹ	down here !
ð eɪ k æ n b iː oʊ	they can be oh .
oʊ d ɪ d j uː d ɪ d aɪ	oh did you did i ?
k ʌ m p l eɪ	come play !
w ʌ t d ʌ z ʃ iː h æ v	what does she have ?
n oʊ ð ɛ ɹ z n ɑː t	no there's not .
oʊ d uː ð eɪ n aʊ	oh do they now ?
ð æ t s h aʊ w iː d uː ɪ t	that's how we do it .
aɪ θ ɪ ŋ k l ɛ t s s iː	i think let's see .
ð æ t s w ʌ t s	that's what's .
k æ n aɪ iː t ɪ t n aʊ	can i eat it now ?
n aʊ w ʌ t s ð æ t ɡ ə n ə b iː	now what's that gonna be ?
k æ n j uː p ʊ t ð æ t ɔ n	can you put that on ?
d uː j uː θ ɪ ŋ k ð æ t s ɹ aɪ t	do you think that's right ?
oʊ d oʊ n t ɡ oʊ oʊ v ɚ ð ɛ ɹ	oh don't go over there !
d uː j uː s iː h ɪ m h ɪ ɹ	do you see him here ?
j uː ɡ oʊ ɪ ŋ t ʊ iː t	you going to eat ?
oʊ l ʊ k w ʌ t aɪ s iː	oh look what i see .
w ɛ l w ʌ t d uː j uː n oʊ	well what do you know ?
oʊ ɪ z ð æ t ɹ aɪ t	oh is that right ?
ð ɪ s ɪ z	this is ?
j uː d oʊ n t w ɔ n t t uː	you don't want to .
ʃ iː d ɪ d ɪ t	she did it ?
ð ɪ s ɪ z eɪ	this is a .
j uː w ɔ n ə p l eɪ t uː	you wanna play too ?
h iː z n ɑː t l ɪ ɾ ə l	he's not little .
aɪ n oʊ h ɪ ɹ	i know here .
ɑː ɹ w iː ɡ ə n ə	are we gonna ?
aɪ w ɔ n t w ʌ n t uː	i want one too !
f ɔː ɹ h ɪ m	for him .
l ɛ t s p ʊ t ɪ ɾ ɔ n h ɪ m	let's put it on him .
aɪ d oʊ n t θ ɪ ŋ k j uː n oʊ	i don't think you know .
ɪ z ð æ t h aʊ j uː n oʊ	is that how you know ?
j uː ɡ oʊ ɪ ŋ t ə d uː w ʌ t	you going to do what ?
n aʊ k æ n aɪ d uː ɪ t	now can i do it ?
d̠ʒ ʌ s t eɪ	just a .
oʊ h ɪ ɹ aɪ ɡ oʊ	oh here i go .
j ɛ h ɹ aɪ t ʌ p h ɪ ɹ	yeah right up here .
w iː d ɪ d ɪ t l ʊ k	we did it look !
ɡ oʊ s iː w ʌ t	go see what ?
w ʌ t ɐ b aʊ t j uː	what about you .
æ n d k ʌ m ɔ n	and come on .
j ɛ h aʊ t	yeah out .
aɪ ɡ ɑː t h ɪ m	i got him !
l ɛ t s s iː w ʌ t s ɪ n h ɪ ɹ	let's see what's in here ?
oʊ ð æ t s n ɑː t f ɔː ɹ j uː	oh that's not for you .
ɪ z ð ɪ s ɔː l	is this all .
oʊ j uː w ɔ n t ɪ ɾ aʊ t	oh you want it out ?
h ɪ ɹ h ɪ ɹ j uː ɡ oʊ	here here you go .
ð ɛ n w ʌ t ɪ z ɪ t	then what is it ?
ð eɪ d̠ʒ ʌ s t ɡ oʊ l aɪ k ð ɪ s	they just go like this .
k æ n w iː d̠ʒ ʌ s t l ʊ k	can we just look ?
aɪ d uː l aɪ k ɪ t	i do like it .
n aʊ w ʌ t s ð ɪ s h ɪ ɹ	now what's this here ?
j ɛ h ɪ t s ɔː l aʊ t	yeah it's all out .
l ʊ k f ɔː ɹ ɪ t	look for it .
d̠ʒ ʌ s t l aɪ k j uː d ɪ d j ɛ h	just like you did yeah .
j uː w ɔ n ə p ʊ t ð ɛ m ɪ n	you wanna put them in ?
æ n d w ɛ n ɪ t s ʌ p	and when it's up .
j uː d̠ʒ ʌ s t w ɔ n t aʊ t	you just want out .
s iː ð ə b eɪ b i	see the baby .
l ʊ k l ʊ k	look look .
w ʌ t ʌ p	what up ?
l ɛ t s h æ v ɪ ɾ ɪ t h ɪ ɹ	let's have it it here .
oʊ k eɪ t ʊ iː t	okay to eat .
p ʊ t ɪ ɾ ɪ n ð ɛ ɹ	put it in there !
ɪ z ð æ t f ɔː ɹ w ʌ t	is that for what ?
w ʌ t s ɡ oʊ ɪ ŋ ɔ n ɹ aɪ t ð ɛ ɹ	what's going on right there ?
w ɛ l h iː ɪ z	well he is .
j uː ɡ oʊ ɪ ŋ j uː n ɑː t	you going you not ?
ɔː ɹ d uː j uː	or do you ?
w ɛ ɹ ɪ z h iː h ɪ ɹ	where is he here ?
ð æ t s ɔː l aɪ d uː	that's all i do .
j uː d uː w ʌ t	you do what ?
ð ɪ s ɪ z d̠ʒ ʌ s t	this is just .
h ɪ m oʊ v ɚ h ɪ ɹ	him over here .
w ʌ t s ʃ iː s eɪ	what's she say ?
aɪ w ɔ n ə	i wanna .
n oʊ oʊ k eɪ	no okay ?
w ɛ l ð ɛ n iː t ɪ t	well then eat it .
ð ɛ ɹ z ð ɪ eɪ	there's the a .
d̠ʒ ʌ s t ɹ aɪ t h ɪ ɹ	just right here .
l ɛ t s s iː j ɛ h ð æ t s ɡ ʊ d	let's see yeah that's good .
h ɪ ɹ l ɛ t s d uː ð ɪ s	here let's do this .
æ n d ð eɪ k æ n	and they can .
j uː s eɪ ɪ t	you say it !
oʊ w ʌ t d ɪ d h iː ɡ ɛ t	oh what did he get ?
j ɛ h aɪ m ɡ ə n ə p l eɪ	yeah i'm gonna play .
w ɛ ɹ d uː w iː ɡ oʊ n aʊ	where do we go now ?
j uː ɡ oʊ l aɪ k ð æ t	you go like that .
oʊ k eɪ h iː z ʌ m	okay he's um .
aɪ k æ n s iː j uː n aʊ	i can see you now .
w ʌ n f ɔː ɹ j uː	one for you !
j uː l aɪ k ɪ t t uː	you like it too ?
b ɪ k ʌ z j uː w ɔ n ə	because you wanna .
æ n d ð ɪ s ɪ z ɔ n	and this is on ?
d ʌ z h iː l aɪ k j uː	does he like you ?
n oʊ aɪ d oʊ n t	no i don't .
s oʊ aɪ θ ɪ ŋ k ð æ t s ɔː l	so i think that's all .
b ʌ t j uː n oʊ	but you know .
j uː d̠ʒ ʌ s t l ʊ k	you just look !
w ʌ t d ʌ z ɪ t s eɪ	what does it say ?
ɹ aɪ t ð ɛ ɹ ð ɛ ɹ z w ʌ n	right there there's one .
d oʊ n t l aɪ k ð æ t	don't like that .
oʊ j ɛ h ð æ t s ɹ aɪ t	oh yeah that's right .
l ɛ t s ɡ oʊ ɪ n h ɪ ɹ	let's go in here !
l aɪ k n aʊ	like now .
j ʊ ɹ n ɑː t ɡ oʊ ɪ ŋ	you're not going .
j uː l ʊ k d̠ʒ ʌ s t l aɪ k ɪ t	you look just like it !
j uː w ɔ n ə iː t n aʊ	you wanna eat now ?
oʊ w ɛ ɹ ð eɪ ɡ oʊ ɪ ŋ	oh where they going ?
w iː ɡ ɛ t ʌ p	we get up .
d oʊ n t j uː ɡ ɛ t ɪ t	don't you get it .
d ɪ d j uː d uː ð æ t	did you do that ?
n oʊ d̠ʒ ʌ s t ɡ oʊ l aɪ k ð æ t	no just go like that .
oʊ aɪ w ɔ n t j uː	oh i want you !
l ʊ k ð ɛ ɹ ɪ z ɪ z	look there is is !
j uː w ɔ n ə k ʌ m aʊ t	you wanna come out ?
j ɛ h j uː ɡ ə n ə ɡ ɛ t h ɜː	yeah you gonna get her ?
j uː θ ɪ ŋ k ɪ ɾ ɪ z	you think it is ?
ð ɛ ɹ h iː ɪ z s iː	there he is see ?
oʊ k eɪ p ʊ t ɪ ɾ ʌ p	okay put it up .
s iː w ʌ t ɪ t d ɪ d	see what it did ?
ʌ m ɪ t s	um it's .
n aʊ d uː ð ɪ s	now do this .
h iː ɡ ɑː t m iː	he got me !
aɪ n oʊ b ʌ t aɪ	i know but i .
l ʊ k w ʌ t ʃ iː d ɪ d	look what she did !
ɡ oʊ s iː w ʌ t ɪ ɾ ɪ z	go see what it is .
ð æ t ɡ oʊ ɹ aɪ t ð ɛ ɹ	that go right there .
l ʊ k h ɪ ɹ	look here !
w ʌ t s æ t w ʌ n	what's at one .
ɪ t s oʊ k eɪ h ɪ ɹ	it's okay here .
æ n d ɔː l ð æ t	and all that .
b ɪ k ʌ z j uː ɑː ɹ	because you are .
w ʌ t ɐ ɡ ʊ d	what a good .
oʊ w ʌ t ð æ t	oh what that .
k æ n j uː k ʌ m oʊ v ɚ h ɪ ɹ	can you come over here ?
w ʌ t d uː j uː p ʊ t ð ɛ ɹ	what do you put there ?
ð ɛ ɹ ð ɛ ɹ j uː ɑː ɹ	there there you are .
w ʌ t j uː ɡ ɑː t ð ɛ ɹ	what you got there ?
w ʌ t j uː w ʌ t	what you what ?
ð ɛ n w ʌ t k æ n w iː d uː	then what can we do ?
n oʊ ð æ t s n ɑː t ɹ aɪ t	no that's not right .
oʊ k eɪ l ɛ t s d uː ð ɪ s	okay let's do this .
w ʌ t ɪ z oʊ l ʊ k	what is oh look .
h ɪ ɹ s iː	here see .
aɪ m ɡ ə n ə p ʊ t ð ɪ s ɪ n	i'm gonna put this in .
w ʌ t ɑː ɹ w iː	what are we ?
w ɛ ɹ d uː aɪ ɡ oʊ	where do i go ?
j ɛ h l ɛ t s p l eɪ ɪ t	yeah let's play it .
oʊ j ɛ h h iː ɪ z	oh yeah he is .
aɪ n oʊ w ʌ t aɪ w ɔ n t	i know what i want .
l ʊ k æ t h ɪ m ɹ aɪ t ð ɛ ɹ	look at him right there .
w ɛ ɹ d ɪ d ð eɪ p ʊ t j uː	where did they put you ?
ɡ oʊ d aʊ n w ɛ ɹ	go down where ?
æ n d ʃ iː d ɪ d ð æ t h ɪ ɹ	and she did that here .
j ɛ h m iː	yeah me .
aɪ s eɪ j uː s eɪ	i say you say .
w ɛ ɹ ɑː ɹ	where are ?
æ n d j uː k æ n d uː ɪ t	and you can do it ?
ɪ z ʃ iː ɡ oʊ ɪ ŋ	is she going ?
n oʊ j uː d oʊ n t n oʊ	no you don't know ?
d ɪ d j uː d̠ʒ ʌ s t s eɪ ð æ t	did you just say that ?
ð æ t ð æ t s ð ə	that that's the .
ɡ oʊ ɔ n d aʊ n	go on down .
aɪ θ ɪ ŋ k ð ɪ s	i think this .
æ n d ð æ t ʃ iː w ʌ z	and that she was .
j uː d oʊ n t s eɪ j uː n oʊ	you don't say you know .
n oʊ w ʌ t d ɪ d ð eɪ d uː	no what did they do ?
w ʌ t ð ə l ʊ k æ t ð æ t	what the look at that !
d ʌ z ɪ t h æ v w ʌ n	does it have one ?
w ʌ t ɐ j uː w ɔ n t	what a you want ?
ʌ p ʌ p	up up ?
æ n d d uː ɪ t	and do it .
ð ə b eɪ b i	the baby .
æ n d m iː	and me .
aɪ w ɔ n ə d̠ʒ ʌ s t ɡ ə n ə s eɪ	i wanna just gonna say .
ɪ t s s oʊ l ɪ ɾ ə l	it's so little !
oʊ oʊ k eɪ h ɪ ɹ w iː ɡ oʊ	oh okay here we go .
j uː w ɔ n t aʊ t d oʊ n t j uː	you want out don't you ?
oʊ ɪ ɾ ɪ z n aʊ	oh it is now .
ð ɛ n w iː k æ n p l eɪ	then we can play ?
l aɪ k w ʌ t d ɪ d	like what did .
j ɛ h ð æ t s oʊ k eɪ ɹ aɪ t	yeah that's okay right ?
p ʊ t j uː ɪ n w ʌ t	put you in what ?
h aʊ d ɪ d j uː ɡ ɛ t ð æ t	how did you get that ?
n oʊ b ʌ t	no but .
ɪ z ʃ iː ɪ n	is she in ?
æ n d w ʌ t d ɪ d aɪ d uː	and what did i do ?
b ɪ k ʌ z j uː θ ɪ ŋ k ɪ t s ɡ ʊ d	because you think it's good ?
w ɔ n ə p l eɪ ð æ t	wanna play that ?
n oʊ ð ɛ ɹ n ɑː t n oʊ	no there not no .
ð ɛ ɹ ð eɪ ɑː ɹ s iː	there they are see .
b ɪ k ʌ z aɪ m t uː b ɪ ɡ	because i'm too big .
j uː k æ n h æ v ð æ t	you can have that .
ʌ p æ t j uː	up at you .
aɪ m w ɪ ð j uː	i'm with you .
oʊ j uː k æ n p l eɪ	oh you can play !
k ʌ m ɔ n æ n d iː t	come on and eat !
w ʌ t s ð ɪ s ɪ n h ɪ ɹ	what's this in here ?
æ n d ð ɛ n w ɛ n ð eɪ s eɪ	and then when they say .
æ n d w ʌ t s ð ɪ s	and what's this .
oʊ l ʊ k h ɪ ɹ	oh look here .
ð eɪ ɡ ɑː t eɪ	they got a .
w ɛ l ɪ t s m aɪ b eɪ b i	well it's my baby .
ð eɪ d oʊ n t ɡ oʊ ɹ aɪ t	they don't go right .
ɑː ɹ j uː ʌ p ð ɛ ɹ	are you up there ?
ð ɪ s ɪ z t uː l ɪ ɾ ə l	this is too little .
ð ɛ n w ʌ t ɑː ɹ j uː	then what are you ?
ɑː ɹ ð eɪ ð ɛ ɹ	are they there ?
aɪ h æ v w ʌ n	i have one !
j uː d oʊ n t p ʊ t ð ɛ m aʊ t	you don't put them out .
ð æ t s w ʌ t j uː w ɔ n t	that's what you want ?
h aʊ aɪ	how i .
oʊ k eɪ h ɪ ɹ w iː ɡ oʊ n aʊ	okay here we go now .
n oʊ n ɑː t ð ɪ s	no not this .
ɑː ɹ j uː s oʊ b ɪ ɡ	are you so big ?
n oʊ b ɪ k ʌ z j ʊ ɹ ɪ n h ɪ ɹ	no because you're in here .
d uː d uː j uː	do do you ?
d̠ʒ ʌ s t b eɪ b i	just baby ?
oʊ ɪ z h iː	oh is he ?
k æ n j uː s eɪ b ɪ ɡ	can you say big ?
n oʊ ɪ t s f ɔː ɹ b eɪ b i	no it's for baby .
oʊ j ɛ h ɪ ɾ ɪ z	oh yeah it is .
j uː d uː aɪ θ ɪ ŋ k	you do i think .
m iː t uː	me too !
ð æ t s w ʌ t aɪ s eɪ	that's what i say .
j ɛ h ɪ t s ʌ p t ə j uː	yeah it's up to you .
d ɪ d ʃ iː d uː	did she do ?
ɪ t s n ɑː t oʊ k eɪ	it's not okay .
æ n d ð ɛ n aɪ d oʊ n t n oʊ	and then i don't know .
k æ n j uː ɡ ɛ t ɪ t n aʊ	can you get it now ?
w ʌ t ɑː ɹ	what are ?
h iː d ɪ d d uː ɪ t	he did do it .
j uː d oʊ n t l ʊ k	you don't look .
w ʌ t s ʌ p w ɪ ð ð æ t	what's up with that ?
k æ n j uː iː t ɪ t	can you eat it ?
ð ɪ s ɪ z t ə ð ə ɹ aɪ t	this is to the right .
aɪ s iː w ʌ n ʌ v ð ɛ m	i see one of them .
s eɪ s eɪ s eɪ	say say say .
j uː iː t ɪ ɾ ɔː l ʌ p	you eat it all up ?
l ɛ t s p ʊ t ð ɪ s ʌ p	let's put this up .
oʊ w ʌ t ɐ b aʊ t h ɪ m	oh what about him ?
n oʊ h ɪ ɹ	no here .
ð ɛ ɹ z ð ə b eɪ b i	there's the baby !
b ʌ t aɪ θ ɪ ŋ k	but i think .
aɪ w ʌ z d̠ʒ ʌ s t aʊ t ð ɛ ɹ	i was just out there .
d uː j uː s iː	do you see ?
h iː k æ n	he can ?
æ n d ð ɛ n ɔ n	and then on .
l aɪ k ð ɪ ʌ m	like the um .
j ʊ ɹ b eɪ b i	your baby .
ɡ ə n ə p ʊ t ð ɪ s ɪ n h ɪ ɹ	gonna put this in here .
ð ɛ ɹ z ɡ ə n ə b iː	there's gonna be .
w ɛ ɹ d ɪ d w iː ɡ oʊ	where did we go ?
j ɛ h ʌ p	yeah up .
ɪ t s j ʊ ɹ b eɪ b i	it's your baby .
h aʊ k ʌ m h iː d oʊ n t	how come he don't ?
w ɛ n ʌ m	when um .
ɔː ɹ ʃ iː	or she .
oʊ j uː d oʊ n t	oh you don't .
aɪ l aɪ k t ʊ iː t	i like to eat .
j uː ɡ ə n ə d uː ɪ t ɹ aɪ t	you gonna do it right ?
ð æ t s t ə p l eɪ w ɪ ð	that's to play with .
oʊ ɡ oʊ	oh go ?
w ɛ l ð æ t s ð ə ɹ aɪ t w ʌ n	well that's the right one .
ɪ t s ɔ n ɹ aɪ t	it's on right ?
ʃ iː d ʌ z ɪ t	she does it .
ɡ ə n ə k ʌ m æ n d ɡ ɛ t j uː	gonna come and get you .
aɪ k æ n t uː	i can too .
ɑː ɹ j uː ɡ oʊ ɪ ŋ ʌ p	are you going up ?
h ɪ ɹ aɪ ɡ ɑː t ɪ t	here i got it .
n aʊ w iː h æ v	now we have .
oʊ k eɪ æ n d ʌ m j ɛ h	okay and um yeah .
oʊ j uː ɡ ɑː t w ʌ n l ʊ k	oh you got one look .
ð æ t s h aʊ ɪ t ɡ oʊ	that's how it go .
w ɛ l æ n d ɐ l ɪ ɾ ə l w ʌ t	well and a little what ?
ð ɛ ɹ z w ʌ n oʊ	there's one oh !
oʊ k ʌ m oʊ v ɚ h ɪ ɹ	oh come over here !
w ʌ t ɑː ɹ w iː ɡ oʊ ɪ ŋ d uː	what are we going do ?
w ʌ t ɪ z ɪ n ð ɛ ɹ	what is in there .
j ʊ ɹ b eɪ b i ɔː ɹ m aɪ b eɪ b i	your baby or my baby ?
w ɛ l j ɛ h j ʊ ɹ ɹ aɪ t	well yeah you're right .
l aɪ k aɪ θ ɪ ŋ k h iː	like i think he .
b ɪ k ʌ z h iː w ʌ z	because he was .
w ɛ ɹ aɪ w ɔ n ə b iː	where i wanna be .
æ n d d aʊ n	and down .
w ɪ ð w ʌ t ɔ n ɪ t	with what on it ?
w ʌ z ʃ iː	was she ?
aɪ d oʊ n t n oʊ ð æ t	i don't know that .
l ɛ t s d̠ʒ ʌ s t l ʊ k	let's just look .
w ɛ ɹ oʊ	where oh !
j uː k æ n p ʊ t ð æ t	you can put that .
n oʊ m aɪ n oʊ	no my no .
oʊ k eɪ l ɛ t s s iː h ɪ ɹ	okay let's see here .
h aʊ d uː j uː n oʊ ɪ t	how do you know it ?
p ʊ t ð ɪ s h ɪ ɹ l aɪ k ð æ t	put this here like that .
d̠ʒ ʌ s t iː t j uː ʌ p	just eat you up !
j uː ɡ oʊ n aʊ	you go now ?
ɪ z ð æ t w ʌ t j uː θ ɪ ŋ k	is that what you think ?
n oʊ j uː ɡ ɛ t w ʌ n	no you get one .
w ɛ l ð ɛ n l ɛ t s p ʊ t	well then let's put .
ð ɛ ɹ ð eɪ ɑː ɹ	there they are ?
n oʊ ɪ t s f ɔː ɹ m iː	no it's for me .
w ɛ l d̠ʒ ʌ s t s eɪ ð æ t	well just say that .
ɪ t w ʌ z n ɑː t	it was not !
ð ɛ ɹ z s ʌ m	there's some !
ð ɛ ɹ z ð ə n oʊ oʊ v ɚ ð ɛ ɹ	there's the no over there .
h aʊ d uː j uː l aɪ k ð ɪ s	how do you like this ?
w ʌ t s ɡ ə n ə iː t	what's gonna eat ?
n oʊ d̠ʒ ʌ s t n aʊ n aʊ	no just now now !
w ʌ t w ʌ t s ɪ t s eɪ	what what's it say ?
p ʊ t m iː ɔ n	put me on .
aɪ m oʊ k eɪ h aʊ ɑː ɹ j uː	i'm okay how are you ?
oʊ æ n d l ʊ k	oh and look .
n oʊ n oʊ ɡ ʊ d	no no good .
w ʌ t ɪ z ɐ w ɔ n t	what is a want ?
n aʊ w ʌ t w ʌ z ð æ t	now what was that ?
ð eɪ h æ v	they have ?
h aʊ ɐ b aʊ t l aɪ k ð ɪ s	how about like this .
b ʌ t h iː d ʌ z	but he does .
s eɪ l ɛ t s ɡ oʊ f ɔː ɹ	say let's go for !
oʊ j uː w ɔ n ə ɡ oʊ n aʊ	oh you wanna go now ?
w ɔ n t m iː t ə k ʌ m t uː	want me to come too ?
ɑː ɹ j uː ɔː l ɡ ə n ə p l eɪ	are you all gonna play ?
j ɛ h j uː d ɪ d ɡ ʊ d	yeah you did good .
l ɛ t s ɡ ɛ t ð ɪ s ɹ aɪ t	let's get this right .
h iː z n ɑː t b eɪ b i n aʊ	he's not baby now .
b ʌ t ð eɪ k æ n p l eɪ t uː	but they can play to .
w ʌ t j uː d oʊ n t w ɔ n t	what you don't want ?
k æ n j uː ɡ ɛ t ɪ t h ɪ ɹ	can you get it here .
oʊ h ɪ m h ɜː	oh him her ?
k ʌ m ʌ p h ɪ ɹ ɹ aɪ t n aʊ	come up here right now .
h iː ʌ p h ɪ ɹ	he up here ?
aɪ h æ v w ʌ n d aʊ n h ɪ ɹ	i have one down here .
n aʊ j ʊ ɹ ɡ ə n ə iː t ɪ t	now you're gonna eat it ?
w ʌ t s ð ɪ s w ɪ ð h ɪ z w ʌ t	what's this with his what ?
w ʌ t w ʌ t w ʌ t w ʌ t w ʌ t	what what what what what ?
ʃ iː w ɔ n ə s iː	she wanna see .
ð æ t s ɡ ʊ d ɹ aɪ t	that's good right .
j ʊ ɹ ɡ ə n ə p ʊ t ð ɛ m ð ɛ ɹ	you're gonna put them there .
j uː l aɪ k ð æ t	you like that !
n oʊ w ʌ t d uː j uː s eɪ	no what do you say ?
h ɪ ɹ ɑː ɹ s ʌ m	here are some .
n aʊ p ʊ t ɪ ɾ ɔ n	now put it on .
w ʌ t k æ n ð eɪ d uː	what can they do ?
p ʊ t ɪ ɾ ʌ p w ɛ ɹ	put it up where ?
h aʊ d ɪ d aɪ d uː ð æ t	how did i do that ?
k æ n ð ɪ s b iː	can this be ?
s iː j uː l aɪ k	see you like .
w ɛ l ɪ f j uː d oʊ n t	well if you don't .
w ʌ t h æ v w iː ɡ ɑː t h ɪ ɹ	what have we got here ?
aɪ m d̠ʒ ʌ s t	i'm just .
w ʌ t d ʌ z h iː d uː ð ɛ ɹ	what does he do there ?
j uː k æ n ɡ oʊ	you can go .
b eɪ b i d oʊ n t	baby don't .
ɡ ə n ə iː t h ɪ m	gonna eat him ?
f ɔː ɹ n aʊ ɪ t s	for now it's .
w ɛ l j uː θ ɪ ŋ k ɐ b aʊ t ɪ t	well you think about it .
d ɪ d j uː s eɪ ʌ m	did you say um ?
d ʌ z ɪ t l ʊ k l aɪ k ð ɪ s	does it look like this ?
æ ɾ ɔː l b ʌ t	at all but .
w ɔ n ə s iː m iː d uː ɪ t	wanna see me do it ?
h ɪ ɹ l ɛ t s p ʊ t ð ɛ m ɔ n	here let's put them on !
s oʊ ð eɪ ð ɛ ɹ ɪ ɾ ɪ z	so they there it is .
æ n d ð eɪ h æ v	and they have .
h aʊ ɑː ɹ j uː d aʊ n ð ɛ ɹ	how are you down there ?
w ɛ l k æ n aɪ iː t ɪ t	well can i eat it ?
n oʊ ɪ t s f ɔː ɹ h ɜː	no it's for her .
l ɛ t s p ʊ t ð ɪ s d aʊ n h ɪ ɹ	let's put this down here .
l ɛ t s ɡ oʊ ɪ n	let's go in .
ɔː ɹ d ɪ d j uː d̠ʒ ʌ s t n oʊ	or did you just know ?
j ɛ h j uː w ɔ n t aʊ t	yeah you want out .
n aʊ j uː w ɔ n ə d uː ð æ t	now you wanna do that ?
l ʊ k h aʊ b ɪ ɡ h iː ɡ ɑː t	look how big he got !
ʌ m ð ɪ s ɪ z ɡ ʊ d	um this is good .
aɪ w ɔ n t j uː	i want you .
aɪ k æ n s iː h ɜː	i can see her .
w ʌ t d ɪ d j uː m eɪ k ð ɛ ɹ	what did you make there ?
w ɛ ɹ ɹ aɪ t h ɪ ɹ	where right here ?
b ɪ k ʌ z ð eɪ d̠ʒ ʌ s t ɑː ɹ	because they just are .
n oʊ j uː k ʌ m oʊ v ɚ h ɪ ɹ	no you come over here .
w ɛ l aɪ θ ɪ ŋ k aɪ h æ v	well i think i have .
æ n d s oʊ ʃ iː	and so she .
θ ɪ ŋ k oʊ k eɪ	think okay ?
ð æ t s w ʌ t j uː s eɪ	that's what you say ?
p ʊ t h ɪ m ɔ n h ɪ ɹ	put him on here .
b eɪ b i j ɛ h	baby yeah !
k æ n j uː ɡ ɛ t w ʌ n	can you get one ?
n oʊ w ʌ t n oʊ w ʌ t	know what know what ?
ð eɪ ɑː ɹ ɹ aɪ t ð ɛ ɹ	they are right there .
oʊ ɪ n ð ɛ ɹ j ɛ h	oh in there yeah .
d ʌ z ɪ t ɡ ɛ t h ɪ m	does it get him ?
æ n d h iː z j ʊ ɹ l ɪ ɾ ə l	and he's your little .
aɪ n oʊ w iː h æ v ɪ t	i know we have it .
p l eɪ ɪ n ɪ t	play in it .
p ʊ t ð æ t ð ɛ ɹ	put that there .
oʊ j ʊ ɹ ɡ ə n ə iː t ɪ t	oh you're gonna eat it ?
l ʊ k w ʌ t w iː h æ v	look what we have .
oʊ d ɪ d ʃ iː d uː ð æ t	oh did she do that ?
w ɛ l l ʊ k ɪ t	well look it .
ð ɪ s oʊ v ɚ ð ɛ ɹ	this over there ?
j ɛ h ɹ aɪ t j ɛ h	yeah right yeah .
d aʊ n ð ɛ ɹ	down there .
j uː d oʊ n t n oʊ ɪ t	you don't know it .
j ɛ h j ʊ ɹ ɹ aɪ t	yeah you're right .
j uː l aɪ k ð ɪ s b eɪ b i	you like this baby ?
oʊ k eɪ j uː w ɔ n ə d uː	okay you wanna do .
j uː ɡ ə n ə m eɪ k s ʌ m	you gonna make some .
oʊ l ɛ t s n ɑː t iː t ð æ t	oh let's not eat that .
ɡ oʊ d uː ɪ t	go do it .
d uː j uː w ɔ n t d aʊ n	do you want down ?
ð ɛ ɹ w ʌ t d ɪ d j uː d uː	there what did you do ?
oʊ w ʌ t d ɪ d j uː d uː	oh what did you do ?
k ʌ m w ɪ ð m iː	come with me !
j uː w ɔ n ə b iː ð ə w ʌ n	you wanna be the one ?
n aʊ j uː ɡ ɑː t ɪ t	now you got it .
ɐ b aʊ t ɪ n h ɪ ɹ	about in here ?
h iː z ɡ ə n ə p l eɪ w ɪ ð j uː	he's gonna play with you ?
w ʌ n k æ n	one can !
n ɑː t s oʊ ɡ ʊ d f ɔː ɹ j uː	not so good for you .
k æ n j uː p ʊ t ð æ t	can you put that .
p ʊ t ɪ ɾ ʌ p ð ɛ ɹ	put it up there ?
d oʊ n t n oʊ w ʌ t h iː ɪ z	don't know what he is .
æ n d w ɛ ɹ ʌ m	and where um .
oʊ k eɪ s oʊ s eɪ ɪ t	okay so say it .
w ʌ t w iː d ɪ d	what we did .
ɪ z ð æ t w ʌ t h iː	is that what he .
ɑː ɹ j uː m aɪ b eɪ b i	are you my baby ?
t ə m aɪ	to my .
aɪ d uː aɪ d uː	i do i do .
n oʊ d̠ʒ ʌ s t p ʊ t ɪ ɾ ʌ p	no just put it up .
ð ɛ ɹ j uː ɡ oʊ ð ɛ ɹ	there you go there .
w ʌ t d ʌ z ɪ t d uː	what does it do .
ð ɪ s ɪ z h aʊ ð eɪ ɡ oʊ	this is how they go .
n oʊ ɐ b ɪ ɡ w ʌ n	no a big one .
j uː d oʊ n t	you don't ?
aɪ m n ɑː t j ʊ ɹ b eɪ b i	i'm not your baby .
l ɛ t s p ʊ t ð ɪ s d aʊ n	let's put this down .
d aʊ n k ʌ m oʊ v ɚ h ɪ ɹ	down come over here .
l ɛ t s p ʊ t ɪ ɾ ɔ n j uː	let's put it on you .
j uː l aɪ k ð ɛ m	you like them ?
w ɛ l ɪ t ɡ ɑː t m iː	well it got me .
s oʊ ɪ t w ʌ z	so it was .
d uː ð ɛ m	do them .
l ʊ k æ ɾ ɔː l ð ɪ s	look at all this !
æ n d w ʌ t ɪ z ð æ t	and what is that .
w ɔ n ə ɡ oʊ s iː ð ə b eɪ b i	wanna go see the baby ?
æ n d w ʌ t ɪ f j uː s eɪ	and what if you say .
w ɛ l w ɛ ɹ ɑː ɹ ð eɪ	well where are they ?
æ n d w ʌ t ð ɪ s	and what this ?
ɡ ɑː t h ɜː	got her ?
j uː w ɔ n ə w ʌ t	you wanna what ?
æ n d w ɛ ɹ ɪ z h iː n aʊ	and where is he now ?
oʊ j uː w ɔ n ə ɡ ɛ t	oh you wanna get .
j uː d oʊ n t θ ɪ ŋ k ɪ ɾ ɪ z	you don't think it is ?
s oʊ ɑː ɹ j uː	so are you ?
w ɛ ɹ d ɪ d ð ə b eɪ b i ɡ oʊ	where did the baby go ?
n oʊ j ʊ ɹ n oʊ ɡ ʊ d	no you're no good .
n aʊ ɪ t s n ɑː t	now it's not .
aɪ w ɔ n ə p ʊ t ɪ t ɹ aɪ t	i wanna put it right .
d oʊ n t s eɪ ð æ t	don't say that .
ð æ t s ɹ aɪ t æ n d w ʌ t s ð ɪ s	that's right and what's this ?
ʌ v w ʌ t	of what ?
s iː ð ɛ ɹ z n oʊ	see there's no .
oʊ j ɛ h h iː d ʌ z	oh yeah he does ?
oʊ w ɛ l oʊ k eɪ	oh well okay .
oʊ k eɪ j ʊ ɹ n ɑː t	okay you're not .
w ɪ ð w ʌ n	with one ?
d oʊ n t m eɪ k h ɜː	don't make her .
ɪ z ð æ t oʊ k eɪ f ɔː ɹ j uː	is that okay for you ?
w ʌ t d ɪ d ɪ t s eɪ	what did it say ?
s oʊ ɪ t s ɪ t s w ʌ t	so it's it's what ?
w ʌ n ɪ n	one in .
j ʊ ɹ oʊ k eɪ h ɪ ɹ	you're okay here .
k æ n aɪ l aɪ k	can i like .
n aʊ w ʌ t s ɡ oʊ ɪ ŋ ɔ n	now what's going on ?
oʊ oʊ k eɪ s iː	oh okay see .
ð æ t s ɹ aɪ t j uː ɑː ɹ	that's right you are .
ð æ t s ɔː l ʌ v ɪ t	that's all of it .
w ɛ l k æ n aɪ	well can i ?
ð ɛ n w ʌ t s ð ɪ s ð ɛ n	then what's this then ?
j ɛ h ɐ b aʊ t	yeah about .
aɪ m ɡ ə n ə ɡ ɛ t j uː	i'm gonna get you !
d uː aɪ ɡ ɛ t t uː	do i get to .
j ɛ h æ n d ð ɛ n	yeah and then .
aɪ w ʌ t d ɪ d aɪ d uː	i what did i do ?
oʊ ɪ z ð æ t ɡ ʊ d	oh is that good .
j ɛ h oʊ k eɪ	yeah okay !
w ɛ l ɡ ɛ t d aʊ n ð ɛ n	well get down then !
oʊ aɪ w ɔ n ə ɡ oʊ	oh i wanna go .
n aʊ p ʊ t ɪ t ɹ aɪ t h ɪ ɹ	now put it right here !
k ʌ m ɔ n ʌ p	come on up !
oʊ aɪ l aɪ k h ɪ m	oh i like him !
j ɛ h ð æ t s m aɪ b eɪ b i	yeah that's my baby .
b ʌ t ɪ t s ɐ k æ n	but it's a can !
d oʊ n t p l eɪ w ɪ ð ð æ t n aʊ	don't play with that now .
n oʊ h iː z ʌ p ð ɛ ɹ	no he's up there .
j uː ɡ ɑː t ɪ t	you got it .
ð eɪ d ɪ d	they did .
h aʊ ɐ b aʊ t f ɔː ɹ b eɪ b i	how about for baby ?
j uː d ɪ d ɐ p l eɪ	you did a play ?
oʊ aɪ d oʊ n t θ ɪ ŋ k s oʊ	oh i don't think so .
d ʌ z ɪ t	does it .
ð eɪ p ʊ t ð eɪ p ʊ t	they put they put .
ɔː l aɪ h æ v ɪ z	all i have is .
ð ɛ ɹ j uː ɡ oʊ b eɪ b i	there you go baby .
d oʊ n t ɡ ɛ t aʊ t	don't get out !
ð ɪ s w ʌ t s ð ɪ s	this what's this ?
ð eɪ l ʊ k b ɪ ɡ	they look big .
j uː w ɔ n ə l ʊ k æ t w ʌ t	you wanna look at what ?
w ɛ l w ʌ t s ð ɪ s ʌ p h ɪ ɹ	well what's this up here ?
oʊ ɹ aɪ t ɹ aɪ t	oh right right .
h iː w ʌ z t uː b ɪ ɡ	he was too big .
oʊ ð ɛ ɹ j uː	oh there you .
æ n d ð ɪ s æ n d ð ɪ s	and this and this .
j ɛ h w ɪ ð j uː	yeah with you .
j ɛ h ð ɛ ɹ h iː ɪ z	yeah there he is !
oʊ oʊ aɪ n oʊ	oh oh i know .
ɡ ʊ d j ɛ h j ɛ h	good yeah yeah .
n oʊ j uː p ʊ t	no you put .
oʊ w ɛ l w ʌ t s ð ɪ s	oh well what's this ?
aɪ k æ n iː t ð ɪ s	i can eat this ?
w ʌ t ʃ iː θ ɪ ŋ k	what she think ?
ɪ z ɹ aɪ t ð ɛ ɹ j ɛ h	is right there yeah .
ɪ t s ɔː l oʊ v ɚ	it's all over ?
oʊ ð eɪ l ʊ k s oʊ ɡ ʊ d	oh they look so good .
n oʊ ð æ t s w ɪ ð ð æ t	no that's with that .
oʊ k eɪ n aʊ l ɛ t s	okay now let's .
ɑː ɹ j uː ɡ oʊ ɪ ŋ t ə p l eɪ	are you going to play ?
w ʌ t s w ɪ ð ɪ t	what's with it ?
s oʊ ɪ t s ʌ m	so it's um .
aɪ θ ɪ ŋ k aɪ m t uː b ɪ ɡ	i think i'm too big .
j ɛ h oʊ l ʊ k	yeah oh look !
d ʌ z ɪ t d̠ʒ ʌ s t	does it just .
d ʌ z ɔː l ð ɪ s k ʌ m	does all this come ?
aɪ m d̠ʒ ʌ s t ɡ ə n ə	i'm just gonna .
j uː l aɪ k h ɜː	you like her .
ɪ t s ɐ aɪ ɹ aɪ t	it's a i right .
f ɔː ɹ ɡ ʊ d	for good .
w ɛ ɹ j uː θ ɪ ŋ k j ʊ ɹ ɡ oʊ ɪ ŋ	where you think you're going ?
w ʌ t j uː ɡ ɑː t ɪ n h ɪ ɹ	what you got in here ?
w ɛ ɹ ɪ z ð ɪ eɪ	where is the a ?
h ɪ ɹ ð ɛ ɹ j uː ɡ oʊ	here there you go .
j uː m eɪ k ɐ w ʌ t	you make a what ?
ɪ z ð ɪ s m iː oʊ v ɚ h ɪ ɹ	is this me over here ?
oʊ w ʌ t d ʌ z ð æ t d uː	oh what does that do ?
w ɪ ð m aɪ	with my ?
l ɛ t s p ʊ t ð ɛ m ɔː l ɔ n	let's put them all on .
oʊ l aɪ k oʊ k eɪ	oh like okay .
h iː z b ɪ ɡ t uː	he's big too ?
n oʊ aɪ d oʊ n t θ ɪ ŋ k ɪ t	no i don't think it .
ɡ ɛ t j ʊ ɹ b eɪ b i	get your baby !
oʊ w iː ɑː ɹ	oh we are ?
k ʌ m ɔ n ɡ ɛ t d aʊ n ð ɛ n	come on get down then .
ɪ n ð ɛ ɹ	in there ?
j ɛ h d uː j uː w ɔ n t w ʌ n	yeah do you want one ?
d oʊ n t n oʊ h aʊ	don't know how .
w ʌ t d ʌ z h iː iː t ð ɛ n	what does he eat then ?
d aʊ n d aʊ n æ n d oʊ v ɚ	down down and over .
d uː j uː ɡ ɛ t ɪ t	do you get it ?
k æ n k ʌ m aʊ t	can come out .
aɪ θ ɪ ŋ k j uː d uː	i think you do .
j uː iː t h ɪ m	you eat him ?
j uː w ɔ n ə ɡ oʊ d aʊ n n aʊ	you wanna go down now ?
k ʌ m ɔ n ʌ p h ɪ ɹ	come on up here .
d ʌ z h iː l aɪ k	does he like ?
w ʌ t d ɪ d h iː d uː	what did he do ?
ɪ t s n ɑː t	it's not !
θ ɪ ŋ k h iː z aʊ t	think he's out .
æ n d h aʊ ɐ b aʊ t m iː	and how about me ?
w ʌ t ɑː ɹ ð eɪ f ɔː ɹ	what are they for ?
w ʌ t ɪ z ð ɪ s d aʊ n h ɪ ɹ	what is this down here .
s eɪ w ʌ n	say one .
s oʊ aɪ	so i .
d oʊ n t iː t m iː ʌ p	don't eat me up !
n oʊ n oʊ j uː s eɪ	no no you say .
ð ɪ s b ɪ ɡ b eɪ b i	this big baby .
ʌ m aɪ d oʊ n t θ ɪ ŋ k s oʊ	um i don't think so .
n oʊ l ʊ k ɪ t	no look it .
aɪ n oʊ j uː l aɪ k	i know you like .
w ɛ l b ɪ k ʌ z θ ɪ ŋ k ɐ b aʊ t ɪ t	well because think about it .
l ɛ t s s iː w ɛ ɹ h iː ɪ z	let's see where he is .
ɹ aɪ t h ɪ ɹ ɔː ɹ ɹ aɪ t ð ɛ ɹ	right here or right there ?
ɔ n m iː ɔː ɹ ɔ n j uː	on me or on you ?
l ʊ k l ʊ k w ʌ t aɪ ɡ ɑː t	look look what i got .
ɹ aɪ t h ɪ z	right his .
oʊ æ n d ð ɛ n w ʌ t	oh and then what ?
w ɛ ɹ w ʌ z h iː	where was he ?
j ɛ h h ɪ ɹ ɪ ɾ ɪ z	yeah here it is .
h iː θ ɪ ŋ k h iː ɔː l ð æ t	he think he all that .
ɪ t s n ɑː t ɪ n h ɪ ɹ	it's not in here ?
ð ɪ ɔː ɹ j ʊ ɹ	the or your ?
d ʌ z ʃ iː h æ v	does she have .
ɔː ɹ d aʊ n h ɪ ɹ	or down here ?
k æ n aɪ h iː z d̠ʒ ʌ s t	can i he's just .
k ʌ m ɔ n aɪ m ɡ oʊ ɪ ŋ	come on i'm going .
aɪ k æ n s iː n aʊ	i can see now .
j ɛ h k ʌ m ɡ ɛ t ð ɛ m	yeah come get them !
l ɛ t s ɡ ɛ t	let's get .
ð ɛ ɹ j ɛ h	there yeah .
j uː w ɔ n t ð ɛ m ɹ aɪ t n aʊ	you want them right now ?
j ʊ ɹ ɹ aɪ t	you're right ?
j ɛ h ð æ t s ɐ ɡ ʊ d b eɪ b i	yeah that's a good baby .
n oʊ ɹ aɪ t h ɪ ɹ	no right here .
h aʊ d ɪ d j uː d uː ð ɪ s	how did you do this ?
ɪ z ð æ t ɔː l h iː d ʌ z	is that all he does ?
ð ɪ s ɡ oʊ ɪ n ð ɛ ɹ	this go in there .
j ʊ ɹ n ɑː t ɡ ə n ə ɡ ɛ t ð ɛ m	you're not gonna get them .
h aʊ k æ n ɪ t d uː ɪ t	how can it do it ?
w iː h æ v ð æ t	we have that .
oʊ k eɪ ɪ t s oʊ k eɪ	okay it's okay .
oʊ j uː θ ɪ ŋ k	oh you think .
w ɛ ɹ d uː ð eɪ	where do they ?
k æ n j uː s eɪ ʌ p d aʊ n	can you say up down ?
j uː d oʊ n t l aɪ k ð ɛ m ɹ aɪ t	you don't like them right ?
j ʊ ɹ n ɑː t ɡ ə n ə iː t ð ɛ m	you're not gonna eat them .
ð ɛ n p ʊ t ɪ ɾ ɔ n	then put it on .
ɡ ɑː t ð ɪ s	got this .
j ɛ h ð æ t s w ʌ t ð æ t ɪ z	yeah that's what that is .
w ʌ t k æ n aɪ ɡ ɛ t	what can i get ?
j uː p ʊ t ð ɪ s d aʊ n h ɪ ɹ	you put this down here .
j uː m aɪ b eɪ b i	you my baby .
n aʊ w ʌ t d uː j uː s iː	now what do you see ?
j uː ɑː ɹ s oʊ ɡ ʊ d	you are so good .
oʊ oʊ aɪ s iː	oh oh i see .
oʊ b eɪ b i d ɪ d	oh baby did .
n oʊ ɪ t s ɪ n	no it's in .
aɪ m ɡ ə n ə p ʊ t ɐ l ɪ ɾ ə l	i'm gonna put a little .
æ n d j uː k æ n h æ v	and you can have .
ð æ t s ɹ aɪ t l ʊ k	that's right look !
w ʌ t d uː j uː θ ɪ ŋ k ʌ m	what do you think um .
j uː k æ n s eɪ ð æ t	you can say that ?
b ʌ t ð æ t s	but that's .
j uː n oʊ w ʌ t	you know what !
ð æ t s n ɑː t n oʊ	that's not no !
w ʌ t w ʌ z w ʌ t w ʌ z ð ɪ s	what was what was this ?
aɪ d ɪ d aɪ d ɪ d	i did i did .
h ɪ ɹ l ʊ k w ʌ t s ð ɪ s	here look what's this ?
ɪ n w iː ɡ oʊ	in we go .
oʊ ð eɪ ɑː ɹ	oh they are ?
d uː j uː ð ə b eɪ b i	do you the baby ?
ɑː ɹ eɪ	are a .
æ n d s ʌ m ð ɛ ɹ	and some there .
p ʊ t ð æ t d aʊ n n aʊ	put that down now .
oʊ j uː iː t ð æ t	oh you eat that .
d ʌ z h iː iː t ɪ t	does he eat it ?
n aʊ ɪ t s w ʌ z	now it's was ?
æ n d æ n d ɐ b ɪ ɡ	and and a big .
n oʊ n ɑː t ɔ n m iː	no not on me !
oʊ j uː ɡ ɑː t ɪ t	oh you got it ?
k æ n w iː p l eɪ w ɪ ð h ɪ m	can we play with him ?
ð æ t s w ʌ t h iː ɪ z	that's what he is .
d̠ʒ ʌ s t l aɪ k ɪ t w ʌ z	just like it was .
k ʌ m ɔ n l ɛ t s d uː ɪ t	come on let's do it .
j ʊ ɹ ɡ ə n ə k ʌ m	you're gonna come ?
ɪ t s oʊ v ɚ ð ɛ ɹ	it's over there ?
ɹ aɪ t ɹ aɪ t	right right ?
oʊ s oʊ h iː w ʌ z l aɪ k	oh so he was like .
t ə ɡ ɛ t d aʊ n	to get down ?
aɪ θ ɪ ŋ k j uː k æ n d̠ʒ ʌ s t	i think you can just .
j uː d ɪ d j ɛ h	you did yeah .
w ɛ l j uː n oʊ aɪ m	well you know i'm .
n ɑː t j uː	not you !
ɑː ɹ j uː ɡ oʊ ɪ ŋ d aʊ n	are you going down ?
p ʊ t ɪ t ɹ aɪ t ʌ p ð ɛ ɹ	put it right up there .
aɪ w ʌ t	i what ?
m eɪ k ð æ t ð ɛ n	make that then .
w ʌ z ʃ iː	was she .
ɪ f aɪ w ɔ n ə	if i wanna ?
h ɪ ɹ h aʊ ɐ b aʊ t	here how about .
k æ n aɪ d̠ʒ ʌ s t l ʊ k	can i just look ?
j ɛ h ɪ t s l aɪ k	yeah it's like .
w ʌ t ɑː ɹ ð ə	what are the ?
w ʌ t ɪ z ð æ t l aɪ k eɪ	what is that like a .
ɡ ɑː t ð ə b eɪ b i	got the baby ?
ɹ aɪ t ð æ t s ɡ ʊ d	right that's good !
ɡ ɛ t ʌ p ɪ f j uː w ɔ n ə	get up if you wanna .
s oʊ ɪ t s oʊ k eɪ	so it's okay .
s eɪ ð ɛ ɹ ɪ ɾ ɪ z	say there it is !
aɪ m ɡ ə n ə h æ v	i'm gonna have .
d oʊ n t d uː ð ɪ s	don't do this !
k æ n j uː ɡ ɛ t ʌ p ʌ p	can you get up up ?
w ʌ t ɐ b aʊ t w ʌ t	what about what ?
oʊ w ʌ t s ð ɪ s	oh what's this .
ð eɪ d oʊ n t w ʌ t	they don't what ?
æ n d n oʊ w ʌ t	and know what ?
j ɛ h w ɛ ɹ d ʌ z ð æ t ɡ oʊ	yeah where does that go ?
ɡ oʊ ɡ oʊ	go go !
w ʌ t s d uː d uː	what's do do ?
w ɔ n ə s iː ð ɛ m	wanna see them ?
oʊ n oʊ w ʌ t s ɡ oʊ ɪ ŋ ɔ n	oh no what's going on ?
h ɪ ɹ l ɛ t s l ʊ k æ t ð ɪ s	here let's look at this !
w ɛ l ɪ t s f ɔː ɹ ɪ t s f ɔː ɹ	well it's for it's for .
w ɛ l h ɪ ɹ ɪ ɾ ɪ z	well here it is .
s iː j uː k æ n d uː ɪ t	see you can do it .
aɪ w ɔ n ə p l eɪ ɪ t	i wanna play it .
oʊ ð ɛ ɹ ʃ iː ɪ z	oh there she is !
ɪ t s n oʊ ɡ ʊ d	it's no good .
j ɛ h ɪ f j uː w ɔ n ə	yeah if you wanna .
l ʊ k j uː w ɔ n ə	look you wanna ?
h iː d ɪ d ɪ t	he did it .
l ɛ t s p ʊ t j uː h ɪ ɹ	let's put you here !
w ɔ n ə k ʌ m	wanna come ?
aɪ aɪ d oʊ n t n oʊ	i i don't know .
j uː iː t s ʌ m t uː	you eat some too .
j uː d uː w ʌ n	you do one .
l ʊ k æ t w ʌ t	look at what ?
w ɛ l ɔː l ɹ aɪ t	well all right .
w ɛ ɹ ɪ z ð ə b eɪ b i	where is the baby ?
l ɛ t s θ ɪ ŋ k	let's think .
w ɛ l j ɛ h ɪ t d ʌ z	well yeah it does .
w ʌ t ɪ z ð ɛ ɹ t ə m eɪ k	what is there to make ?
w ɔ n ə ɡ ɛ t d aʊ n	wanna get down .
oʊ ɪ t s f ɔː ɹ j uː	oh it's for you ?
ɹ aɪ t ð ɛ ɹ ɹ aɪ t ð ɛ ɹ b eɪ b i	right there right there baby .
æ n d ð ɛ n w iː k æ n iː t	and then we can eat .
k æ n ʃ iː m eɪ k ɪ t	can she make it ?
t ə ɡ oʊ h ɪ ɹ	to go here .
b ɪ k ʌ z d uː j uː s iː	because do you see ?
j ɛ h ɑː ɹ	yeah are ?
l aɪ k ð ɪ s s iː	like this see .
ɐ oʊ k eɪ	a okay .
d uː j uː l aɪ k ð æ t	do you like that ?
ɪ t s oʊ k eɪ ɡ oʊ ɡ ɛ t ɪ t	it's okay go get it .
oʊ n oʊ	oh no !
oʊ aɪ d oʊ n t n oʊ ʌ m	oh i don't know um .
l ɪ ɾ ə l eɪ	little a .
l aɪ k ð æ t	like that ?
d uː j uː h æ v ɐ ʌ m	do you have a um .
j ɛ h b ʌ t ð ɪ s n oʊ	yeah but this no !
ɪ z h iː ɪ n ð ɛ ɹ	is he in there ?
h aʊ d uː j uː iː t ð ɛ m	how do you eat them ?
ð æ t s n ɑː t ɪ t	that's not it .
j ʊ ɹ oʊ k eɪ oʊ k eɪ ɡ ʊ d	you're okay okay good !
aɪ w ɔ n t ɪ t ð ɛ ɹ	i want it there .
d uː j uː w ɔ n t ð æ t aʊ t	do you want that out ?
æ n d w iː p ʊ t ð ɛ m ɔ n	and we put them on .
l ɛ t s s iː w ʌ t h iː d ɪ d	let's see what he did .
l ɛ t s s iː d ɪ d ð ə	let's see did the .
w ɛ ɹ k æ n h iː b iː	where can he be ?
æ n d s oʊ b ɪ ɡ	and so big .
n oʊ aɪ θ ɪ ŋ k ð æ t s ð ə	no i think that's the .
l aɪ k ð ɪ s aɪ m d̠ʒ ʌ s t ɡ ə n ə	like this i'm just gonna .
oʊ k eɪ oʊ k eɪ	okay okay .
ð eɪ ɡ ə n ə iː t ɪ t	they gonna eat it ?
w ɛ l w ɛ ɹ d ɪ d w iː ɡ oʊ	well where did we go ?
j uː h æ v ð ɛ m aɪ n oʊ	you have them i know !
n aʊ aɪ ɡ ɑː t ɪ t ɹ aɪ t	now i got it right .
j ɛ h s iː	yeah see ?
p ʊ t ɪ n f ɔː ɹ j uː	put in for you .
ð ɛ n l aɪ k ð ɪ s	then like this .
l ʊ k oʊ v ɚ h ɪ ɹ l ʊ k	look over here look .
ɹ aɪ t h ɪ ɹ l ʊ k ɹ aɪ t ð ɛ ɹ	right here look right there .
p ʊ t ɪ ɾ ʌ p	put it up !
s eɪ k ʌ m ɔ n	say come on !
ɔː l ɹ aɪ t ð ɛ ɹ j uː ɡ oʊ	all right there you go .
d ɪ d j uː p ʊ t ɪ t h ɪ ɹ	did you put it here ?
oʊ k eɪ d uː j uː h æ v	okay do you have .
l ɛ t s d uː oʊ k eɪ	let's do okay .
ɔː ɹ l ɪ ɾ ə l eɪ	or little a .
aɪ n oʊ ɪ z ɪ t ɡ ʊ d	i know is it good ?
w ɛ l j ɛ h	well yeah .
ɹ aɪ t j ɛ h aɪ θ ɪ ŋ k s oʊ	right yeah i think so .
m aɪ b eɪ b i ɪ z	my baby is .
w ɛ l w ʌ t d uː j uː s iː	well what do you see ?
n oʊ s iː	no see .
oʊ k eɪ ð ɛ ɹ ð æ t s ɡ ʊ d	okay there that's good .
j uː w ɔ n ə d uː eɪ	you wanna do a .
d ɪ d j uː s iː ð ə b eɪ b i	did you see the baby .
w ɔ n ə ɡ ɛ t	wanna get ?
l ʊ k ɪ t w ʌ t	look it what ?
w ɔ n ə p ʊ t ð ɛ m ɪ n	wanna put them in ?
j uː iː t	you eat .
w ɛ ɹ k æ n j uː p ʊ t ð æ t	where can you put that ?
oʊ k eɪ d oʊ n t ɡ ɛ t m iː	okay don't get me .
oʊ h ɪ ɹ h ɪ ɹ h ɪ ɹ h ɪ ɹ	oh here here here here .
n oʊ ɪ t s n ɑː t m iː	no it's not me .
j ɛ h aɪ θ ɪ ŋ k ɪ t w ʌ z	yeah i think it was .
ɹ aɪ t ð ɛ ɹ j uː ɡ oʊ	right there you go .
aɪ w ɔ n ə p l eɪ ɹ aɪ t h ɪ ɹ	i wanna play right here .
æ n d l ɛ t s ɡ ɛ t j ʊ ɹ	and let's get your .
l ɛ t s ɡ oʊ æ n d p l eɪ	let's go and play .
w ʌ n æ n d	one and .
aɪ w ɔ n t j uː t ə d uː	i want you to do .
ɪ z j uː	is you .
æ n d θ ɪ ŋ k ʌ v ɪ t	and think of it .
aɪ l aɪ k t ə p l eɪ	i like to play .
ɔː l ɪ t	all it .
h aʊ d ɪ d ʃ iː	how did she .
h ɪ ɹ h ɪ ɹ	here here .
d ʌ z t uː	does too !
n oʊ j uː iː t ɪ ɾ ʌ p	no you eat it up .
ð ɪ s ɪ z ɐ l ɪ ɾ ə l	this is a little .
k ʌ m w ɛ ɹ	come where ?
ɡ ɛ t aʊ t h ɪ ɹ	get out here !
t ə ɡ oʊ w ɛ ɹ	to go where ?
j ɛ h w ɛ ɹ d ɪ d ɪ t ɡ oʊ	yeah where did it go ?
j uː n oʊ l aɪ k d̠ʒ ʌ s t	you know like just .
j ɛ h ɪ t s ɡ ə n ə	yeah it's gonna .
ð ɛ n ð ɛ ɹ z ð æ t	then there's that .
n oʊ h ɪ ɹ w iː ɡ oʊ	no here we go .
ɪ z ð æ t oʊ v ɚ ð ɛ ɹ	is that over there ?
oʊ k eɪ l ʊ k æ t ð ɪ s h ɪ ɹ	okay look at this here .
h æ v h æ v h æ v	have have have .
aɪ n oʊ aɪ d̠ʒ ʌ s t	i know i just .
j ɛ h aɪ l aɪ k	yeah i like .
s ʌ m ɑː ɹ	some are .
aɪ d oʊ n t ɪ f h iː ɪ z	i don't if he is .
j uː s iː w ɛ ɹ ɪ ɾ ɪ z	you see where it is ?
j ɛ h k æ n j uː m eɪ k w ʌ n	yeah can you make one ?
aɪ s iː h ɪ m ɹ aɪ t h ɪ ɹ	i see him right here .
ɡ oʊ ɡ oʊ ɡ oʊ	go go go .
w ʌ t s ʌ p w ɪ ð h ɜː	what's up with her ?
æ n d ð ɛ ɹ	and there .
oʊ j uː w ɔ n t ð æ t	oh you want that .
ʌ m s oʊ w iː ɡ oʊ ɪ n	um so we go in .
d̠ʒ ʌ s t l aɪ k m iː	just like me ?
w ɛ ɹ ð eɪ ɡ oʊ ɪ ŋ æ t	where they going at ?
w ʌ t d ʌ z ʃ iː m eɪ k	what does she make ?
oʊ n oʊ d oʊ n t d uː ð æ t	oh no don't do that !
ɹ aɪ t j uː	right you .
oʊ n aʊ k æ n h iː s iː	oh now can he see ?
w ʌ t d uː j uː ɡ oʊ	what do you go .
k æ n j uː d uː ð æ t	can you do that .
oʊ k eɪ l ɛ t s l ʊ k æ t ð æ t	okay let's look at that .
ð eɪ s iː j uː	they see you !
p ʊ t ɪ ɾ aʊ t	put it out .
ɪ t s ʌ p h ɪ ɹ	it's up here .
b ʌ t j uː d oʊ n t n oʊ w ɛ n	but you don't know when .
j uː ɑː ɹ j uː ɑː ɹ	you are you are .
j uː b eɪ b i	you baby !
l ʊ k ð ə ð ɛ ɹ	look the there .
æ n d j ʊ ɹ	and you're .
w ʌ n l aɪ k ð ɪ s	one like this .
ʌ m n ɑː t l aɪ k ð æ t n oʊ	um not like that no .
oʊ h iː z ɡ oʊ ɪ ŋ	oh he's going .
ɪ ɾ ɪ z t uː	it is too .
aɪ w ɔ n t w ʌ n	i want one .
ʌ m ɪ t s ɡ ɑː t	um it's got .
aɪ θ ɪ ŋ k ð æ t s oʊ k eɪ	i think that's okay .
ʌ m b ʌ t j ɛ h ɪ t d̠ʒ ʌ s t	um but yeah it just .
w ʌ t w ʌ t d ʌ z h iː w ʌ t	what what does he what ?
d ʌ z ʃ iː l ʊ k l aɪ k m iː	does she look like me ?
ɪ t s n ɑː t ʌ p h ɪ ɹ	it's not up here .
w ʌ t s ð ɪ s oʊ v ɚ h ɪ ɹ	what's this over here ?
j uː w ɔ n t s ʌ m n aʊ	you want some now ?
w ɛ n j uː	when you .
ɡ oʊ l aɪ k ð ɪ s ɡ oʊ	go like this go .
aɪ w ʌ z b ɪ ɡ	i was big ?
ɑː ɹ j uː ɐ l ɪ ɾ ə l b eɪ b i	are you a little baby ?
æ n d ʌ m oʊ	and um oh .
oʊ b eɪ b i oʊ	oh baby oh !
aɪ w ɔ n t s ʌ m t uː	i want some too .
w ɛ ɹ w iː ɡ ə n ə ɡ oʊ n aʊ	where we gonna go now ?
w ʌ t ɐ b aʊ t ɪ n h ɪ ɹ	what about in here ?
w ɛ l ð ɛ n d uː ɪ t	well then do it .
ð eɪ h æ v ð ɪ s æ t	they have this at .
l ɛ t s p l eɪ w ɪ ð ð ɪ s	let's play with this .
s iː ɪ f ð æ t	see if that .
oʊ h aʊ ɐ b aʊ t ð æ t	oh how about that ?
s oʊ iː t	so eat .
p ʊ t ð ə	put the !
d uː j uː n oʊ w ʌ t	do you know what ?
w ɛ l ɡ ʊ d f ɔː ɹ j uː	well good for you .
n oʊ oʊ oʊ k eɪ	no oh okay !
aɪ ɡ oʊ w ɪ ð j uː	i go with you .
w ɛ n w ʌ t	when what ?
oʊ k eɪ s eɪ	okay say .
s oʊ iː t ɪ t	so eat it ?
w ʌ t w ʌ t d uː j uː s iː	what what do you see ?
ʌ m p l eɪ w ɪ ð h ɪ m	um play with him .
s iː j uː	see you !
n aʊ j uː d ɪ d ɪ t	now you did it .
ð ɛ ɹ ɪ z w ʌ n ɪ n ð ɛ ɹ	there is one in there .
s oʊ j uː w ɔ n ə b iː	so you wanna be .
aɪ θ ɪ ŋ k ð ɛ ɹ z s ʌ m ð ɛ ɹ	i think there's some there .
ɪ t s m aɪ	it's my .
oʊ ɪ t	oh it .
oʊ k eɪ j ɛ h	okay yeah .
l ɛ t s s iː w ʌ t	let's see what ?
oʊ oʊ k eɪ l aɪ k ð ɪ s	oh okay like this .
ɹ aɪ t ɡ oʊ	right go .
l ʊ k d ʌ z ɪ t ɡ oʊ h ɪ ɹ	look does it go here ?
d ɪ d j uː n aʊ	did you now ?
w ʌ t d uː aɪ h æ v ɔ n	what do i have on ?
d oʊ n t s eɪ	don't say .
j uː ɹ aɪ t j ɛ h	you right yeah .
oʊ w ʌ t ɐ b aʊ t ð ɪ s	oh what about this ?
n oʊ b ʌ t j uː d uː ɪ t	no but you do it .
ɹ aɪ t h ɪ ɹ ɹ aɪ t ð ɛ ɹ	right here right there .
j ɛ h oʊ j ɛ h	yeah oh yeah .
w ʌ t ɪ z ð æ t ɡ ə n ə d uː	what is that gonna do ?
s oʊ j uː d oʊ n t	so you don't .
ð æ t s oʊ k eɪ oʊ k eɪ oʊ k eɪ	that's okay okay okay .
l ʊ k j uː s iː	look you see .
p l eɪ w ɪ ð ð ɛ m n aʊ	play with them now .
oʊ ʃ iː ɪ z	oh she is ?
w ɛ n d ɪ d j uː m eɪ k ɪ t	when did you make it ?
ɪ t s ɔ n	it's on !
d ɪ d w iː ɡ oʊ ð ɛ ɹ	did we go there ?
ɪ z ð æ t l aɪ k j ʊ ɹ b eɪ b i	is that like your baby ?
ð æ t s ɹ aɪ t ð ɛ ɹ j uː ɡ oʊ	that's right there you go .
s oʊ w ʌ t s	so what's .
b ʌ t ð æ t	but that .
oʊ s eɪ	oh say .
t uː t uː b ɪ ɡ	too too big ?
j uː l aɪ k ɪ t h ɪ ɹ	you like it here ?
j ɛ h d uː ð æ t	yeah do that ?
ð æ t s w ɛ ɹ j uː iː t	that's where you eat ?
w ʌ n w ʌ n w ʌ n	one one one .
w ɔ n ə iː t	wanna eat .
l aɪ k ð æ t b ɪ ɡ w ʌ t	like that big what ?
d ɪ d j uː ɡ ɛ t	did you get .
oʊ j uː d ɪ d	oh you did .
w ʌ t ɑː ɹ j uː ɡ ə n ə iː t	what are you gonna eat ?
æ n d w iː k æ n iː t ɪ t	and we can eat it ?
aɪ aɪ ɡ ɑː t s ʌ m	i i got some .
ʌ m l ɛ t s s iː	um let's see .
h aʊ ɐ b aʊ t ð æ t	how about that ?
j uː w ɔ n t	you want ?
ɹ aɪ t ð ɛ ɹ ð ɛ ɹ ɪ ɾ ɪ z	right there there it is .
ð eɪ d̠ʒ ʌ s t d uː ð ɛ m	they just do them .
w ɛ l d uː ð ɛ m	well do them .
b ʌ t aɪ w ɔ n ə ɡ ɛ t	but i wanna get .
s oʊ w ʌ t h æ v aɪ ɡ ɑː t	so what have i got .
w ɛ l j uː ɑː ɹ ʌ p	well you are up .
æ n d æ n d ʌ m	and and um .
ð æ t s w ʌ t ð eɪ	that's what they .
æ n d ð ɛ n j uː ɡ ɛ t ɔ n	and then you get on .
n oʊ n ɑː t f ɔː ɹ n aʊ	no not for now .
aɪ h æ v ɪ t	i have it !
oʊ ð eɪ d uː oʊ k eɪ	oh they do okay .
w ʌ t d ʌ z l ʊ k l aɪ k	what does look like ?
oʊ k eɪ w iː k æ n ɡ oʊ	okay we can go .
h iː d̠ʒ ʌ s t ɡ ɑː t h ɪ ɹ	he just got here .
w ɛ l ɪ ɾ ɪ z ɐ b eɪ b i	well it is a baby .
ʌ p æ n d d aʊ n	up and down .
w ʌ t d ɪ d ʃ iː d uː h ɪ ɹ	what did she do here ?
ð æ t w ʌ z ɔː l oʊ k eɪ	that was all okay .
d ʌ z ʃ iː d uː ð æ t	does she do that ?
aɪ n oʊ b ɪ k ʌ z j uː	i know because you .
n aʊ w ʌ t s ð ɪ s ʌ p h ɪ ɹ	now what's this up here ?
w iː h æ v ɐ w ʌ t h ɪ ɹ	we have a what here ?
j uː w ɔ n t m iː h æ v w ʌ n	you want me have one ?
k ʌ m ɔ n j uː w ɔ n ə	come on you wanna ?
oʊ k eɪ ɪ z ð æ t ɔː l	okay is that all ?
n aʊ m eɪ k s ʌ m	now make some .
ð æ t s l ɪ ɾ ə l j uː ɪ n ð ɛ ɹ	that's little you in there .
w ɛ l ɡ ʊ d	well good !
j uː ɑː ɹ j uː ɑː ɹ	you are you are !
n oʊ ð ə w ʌ n oʊ v ɚ ð ɛ ɹ	no the one over there .
w ɔ n t s ʌ m ʌ v ð ɛ m	want some of them ?
w ɛ n j uː d ɪ d ð æ t	when you did that ?
w ɛ l h iː z ɹ aɪ t ð ɛ ɹ	well he's right there .
ð æ t j uː	that you ?
ð ə b eɪ b i oʊ v ɚ	the baby over .
j uː n oʊ w ʌ t ɪ t	you know what it .
k ʌ m ɔ n n aʊ	come on now !
oʊ k eɪ p ʊ t ɪ ɾ ɪ n h ɪ ɹ	okay put it in here .
d ɪ d j uː d uː ð ɛ m ɔː l	did you do them all ?
oʊ k eɪ m aɪ	okay my .
w ɛ l j uː ɡ ɑː t t ə ð ɛ ɹ	well you got to there .
k æ n aɪ l ʊ k	can i look ?
j uː d oʊ n t w ɔ n t h ɪ m t uː	you don't want him to ?
w ʌ t s ɪ t	what's it .
j uː p ʊ t ɪ ɾ ɔ n ð ɛ ɹ	you put it on there !
oʊ aɪ ɡ ɑː t j uː	oh i got you !
oʊ k eɪ w ɛ ɹ w ʌ z w iː æ t	okay where was we at ?
n oʊ b ɪ k ʌ z j ʊ ɹ	no because you're .
æ n d ð ɪ s ɪ z oʊ	and this is oh .
j uː s eɪ j uː	you say you ?
aʊ t aʊ t w ɪ ð j uː	out out with you !
oʊ w ʌ t eɪ	oh what a .
h ɪ ɹ l ʊ k ɪ t	here look it !
æ n d l ʊ k f ɔː ɹ	and look for .
b ʌ t aɪ d uː	but i do .
p ʊ t ɪ t ɹ aɪ t ɪ n ð ɛ ɹ	put it right in there .
ɹ aɪ t ð ɛ ɹ æ n d w ʌ t s ð ɪ s	right there and what's this ?
j ɛ h ð eɪ d uː	yeah they do .
h iː d ɪ d ɪ t l aɪ k ð æ t	he did it like that ?
ɐ æ n d ð ɛ n	a and then .
d ɪ d j uː ɡ ɛ t w ʌ n	did you get one ?
h ɪ ɹ ɡ oʊ j ʊ ɹ l ɪ ɾ ə l	here go your little .
w ʌ t s ɪ n ð ɛ ɹ ʌ m	what's in there um ?
l ʊ k l ʊ k æ t ð ɪ s	look look at this .
w ɔ n ə k ʌ m ʌ p æ n d s iː	wanna come up and see ?
l aɪ k ð ə w ʌ n ʌ p ð ɛ ɹ	like the one up there .
w ʌ t s ð ə w ʌ n j uː h æ v	what's the one you have ?
w ɔ n ə m eɪ k ð æ t	wanna make that ?
ɔː ɹ j ɛ h m iː	or yeah me ?
oʊ k eɪ j uː n oʊ w ʌ t	okay you know what ?
ɪ ɾ ɪ z eɪ	it is a .
ð ɪ s b ɪ ɡ w ʌ n	this big one .
h aʊ ɪ z ɪ t	how is it .
j uː n oʊ aɪ d oʊ n t	you know i don't .
j uː d oʊ n t s iː h ɪ m	you don't see him .
j uː p l eɪ oʊ v ɚ h ɪ ɹ	you play over here .
w ʌ t s ɡ oʊ ɪ ŋ ɔ n	what's going on .
n aʊ w ʌ t ɐ b aʊ t oʊ v ɚ h ɪ ɹ	now what about over here ?
ɪ t s d̠ʒ ʌ s t n ɑː t ɪ n h ɪ ɹ	it's just not in here .
æ n d ð æ t ɪ z	and that is ?
j ʊ ɹ n ɑː t ɡ oʊ ɪ ŋ aʊ t	you're not going out ?
l ʊ k æ t w ʌ t j uː d ɪ d	look at what you did .
l ʊ k l ɪ ɾ ə l w ʌ n	look little one !
j uː w ɔ n t t ə ɡ ɛ t aʊ t	you want to get out ?
w ʌ t d uː j uː h æ v n aʊ	what do you have now ?
ɔː ɹ ɪ z ɪ t d̠ʒ ʌ s t w ʌ n	or is it just one ?
j ʊ ɹ ɡ oʊ ɪ ŋ t ʊ iː t n aʊ	you're going to eat now .
w ɔ n ə s iː w ʌ t s oʊ v ɚ h ɪ ɹ	wanna see what's over here ?
d ɪ d j uː d ɪ d j uː l ʊ k	did you did you look ?
w ʌ t s ɹ aɪ t	what's right ?
b ʌ t h iː z ð ɛ ɹ n aʊ	but he's there now .
j ɛ h j ɛ h ð æ t s ɹ aɪ t h iː	yeah yeah that's right he .
k ʌ m ɔ n n oʊ	come on no .
oʊ k eɪ ð ɛ ɹ n aʊ	okay there now .
l ɛ t s s iː l ʊ k æ t ð ɪ s	let's see look at this !
l ɛ t s l ɛ t s d̠ʒ ʌ s t d uː ð ɪ s	let's let's just do this .
k ʌ m s iː m iː	come see me !
w ɛ l h ɪ ɹ w ʌ t ɪ z h iː	well here what is he ?
oʊ k eɪ ʌ p	okay up .
oʊ ɐ b eɪ b i	oh a baby .
d̠ʒ ʌ s t w ʌ n	just one ?
ɔː ɹ p l eɪ	or play .
aɪ d oʊ n t n oʊ d ʌ z ɪ t	i don't know does it ?
oʊ aɪ n oʊ w ʌ t ɪ t	oh i know what it .
l ɛ t s l ɛ t s s iː	let's let's see .
w iː d oʊ n t	we don't ?
w iː iː t ð æ t	we eat that .
ɔː ɹ w ʌ t ɐ b aʊ t ð ɪ s ʌ m	or what about this um ?
j ɛ h b ʌ t	yeah but ?
d ɪ d j uː iː t ɪ t	did you eat it ?
l ɛ t s ɡ ɛ t ʌ p	let's get up !
w ɔ n t ɪ ɾ ɪ n ɪ t	want it in it ?
w ʌ t d uː w iː s iː	what do we see ?
l ʊ k k ʌ m h ɪ ɹ	look come here .
n oʊ ð ə k æ n	no the can .
l ʊ k w ʌ t s ð ɪ s	look what's this ?
æ n d w ɛ ɹ ɑː ɹ ð eɪ	and where are they ?
n oʊ w ʌ t j uː d uː	know what you do ?
d̠ʒ ʌ s t s eɪ n oʊ	just say no .
w iː l aɪ k h ɪ m	we like him .
ɪ z ð æ t ɔː l ɹ aɪ t	is that all right ?
aɪ n oʊ ɹ aɪ t	i know right .
oʊ oʊ ð æ t s	oh oh that's .
p ʊ t ð ɛ m ɔː l ɪ n	put them all in .
d uː aɪ h æ v ɐ b eɪ b i	do i have a baby ?
j ʊ ɹ ɡ oʊ ɪ ŋ t ə ɡ ɛ t ð æ t	you're going to get that ?
j ɛ h aɪ w ɔ n t s ʌ m t uː	yeah i want some too .
aʊ t w ʌ t	out what ?
j uː ɡ ɑː t w ʌ t j uː w ɔ n t	you got what you want ?
d uː ð eɪ h æ v w ʌ n ð ɛ ɹ	do they have one there ?
ɑː ɹ ð eɪ oʊ v ɚ h ɪ ɹ	are they over here ?
w ɛ l j uː d uː w ɔ n t s ʌ m	well you do want some .
t ə p ʊ t ð ɪ s d aʊ n	to put this down .
j ɛ h p ʊ t ɪ ɾ ɔ n ð ɛ ɹ	yeah put it on there .
l aɪ k ð æ t ð ɛ ɹ	like that there .
d ʌ z h iː s eɪ	does he say .
j uː ɡ ə n ə p ʊ t ð ɛ m ʌ p	you gonna put them up ?
æ n d w ʌ t ɐ b aʊ t ð ɪ s	and what about this ?
j uː k æ n ɡ ɛ t aʊ t	you can get out .
oʊ w ʌ t s	oh what's ?
ɪ t s ɔː l	it's all .
w ʌ t ɐ j uː ɡ ɑː t	what a you got ?
k æ n ð æ t ɡ oʊ ɪ n ð ɛ ɹ	can that go in there ?
oʊ d ɪ d j uː s iː ð ɪ s	oh did you see this ?
k æ n j uː k ʌ m	can you come ?
oʊ m iː	oh me ?
ð ɛ n ɪ t s ɡ oʊ ɪ ŋ	then it's going ?
d ʌ z ɪ t j ɛ h	does it yeah ?
d oʊ n t n aʊ	don't now .
n oʊ n oʊ n ɑː t ɡ ʊ d	no no not good .
ð æ t s w ʌ t ð eɪ iː t	that's what they eat .
p ʊ t h ɪ m ʌ p ð ɛ ɹ	put him up there .
w ʌ t ɑː ɹ j uː oʊ k eɪ	what are you okay ?
j ɛ h aɪ n oʊ w ʌ t	yeah i know what .
j ʊ ɹ ɡ ə n ə l aɪ k ɪ t	you're gonna like it .
aɪ s eɪ m eɪ k ɪ t	i say make it .
æ n d w ʌ n w ʌ t s ð æ t	and one what's that ?
k æ n j uː m eɪ k m iː s ʌ m	can you make me some ?
l ʊ k æ ɾ ɔː l ʌ v ð ɛ m	look at all of them .
k ʌ m oʊ v ɚ h ɪ ɹ oʊ k eɪ	come over here okay ?
oʊ ɐ b eɪ b i w ʌ n	oh a baby one .
w ʌ t ɪ z ð æ t ð æ t ð æ t	what is that that that ?
l ɛ t s s iː w ʌ t ð eɪ d uː	let's see what they do .
l ɛ t s ɡ oʊ ð ɛ n	let's go then .
ɪ f j uː d oʊ n t l aɪ k ɪ t	if you don't like it .
j uː n oʊ ð ɛ ɹ z ð ə	you know there's the .
oʊ v ɚ ð ɛ ɹ oʊ v ɚ ð ɛ ɹ	over there over there .
t uː t uː b ɪ ɡ	too too big .
j uː s iː j uː	you see you .
ð æ t f ɔː ɹ j uː	that for you .
ɹ aɪ t w ɛ ɹ ɪ ɾ ɪ z	right where it is .
ɡ oʊ ɔ n ɡ ɛ t ɪ n	go on get in .
oʊ ɡ oʊ ɪ ŋ ɪ n ð ɛ ɹ oʊ	oh going in there oh .
w ʌ t s ʌ p ð ɛ ɹ	what's up there ?
ɪ z h iː l ɪ ɾ ə l ɔː ɹ b ɪ ɡ	is he little or big ?
ɪ t s ɹ aɪ t d aʊ n h ɪ ɹ	it's right down here .
w ʌ n ɪ z	one is .
ð ɪ s ð ɪ s ɪ z f ɔː ɹ m iː	this this is for me ?
n aʊ aɪ m ɡ ə n ə ɡ ɛ t j uː	now i'm gonna get you .
ɪ t w ʌ z ð ɪ s b ɪ ɡ	it was this big .
ɪ z ð æ t w ʌ t	is that what .
j ɛ h aɪ θ ɪ ŋ k ʃ iː ɪ z	yeah i think she is .
k ʌ m oʊ v ɚ h ɪ ɹ b eɪ b i	come over here baby .
b ʌ t aɪ n oʊ ð æ t	but i know that .
ɪ t s oʊ k eɪ	it's okay ?
aɪ d uː oʊ k eɪ	i do okay .
ʌ m oʊ k eɪ ɡ ɛ t ð ə	um okay get the .
w ɔ n ə ɡ ɛ t m iː d aʊ n h ɪ ɹ	wanna get me down here ?
ð æ t s ɔː l aɪ w ɔ n t	that's all i want .
s iː n aʊ	see now .
d ʌ z h iː h æ v h ɪ z	does he have his .
w ɛ ɹ aɪ d oʊ n t n oʊ	where i don't know .
ɑː ɹ ʌ m	are um .
p ʊ t ð ɛ m ʌ m	put them um .
oʊ w ɛ ɹ d ɪ d j uː ɡ oʊ	oh where did you go ?
oʊ w ɛ l ð ɛ n j ɛ h oʊ k eɪ	oh well then yeah okay .
d ɪ d aɪ s iː ɪ t	did i see it ?
w ʌ t d ʌ z ɪ t s eɪ h ɪ ɹ	what does it say here ?
æ n d ɡ ɛ t eɪ	and get a .
ð æ t s w ɛ ɹ	that's where ?
ɹ aɪ t ʌ p h ɪ ɹ s iː	right up here see ?
aɪ w ɔ n ə b iː ð ɪ s	i wanna be this .
h ɪ ɹ ɪ z j ʊ ɹ	here is your .
j uː k ʌ m w ɪ ð m iː	you come with me .
ð ɛ n w ʌ t w iː d uː	then what we do ?
oʊ aɪ m ɡ ə n ə ɡ ɛ t	oh i'm gonna get .
ʌ m aɪ d oʊ n t n oʊ	um i don't know .
aɪ n oʊ	i know !
j uː w ɔ n t ð ɪ s b eɪ b i	you want this baby .
n aʊ w ʌ t w ʌ z ð æ t f ɔː ɹ	now what was that for ?
oʊ j uː p ʊ t ɪ ɾ ɪ n	oh you put it in .
oʊ ʃ iː d ɪ d	oh she did .
w ʌ t d uː θ ɪ ŋ k h iː d ɪ d	what do think he did ?
ɡ oʊ d aʊ n æ n d aʊ t	go down and out .
d ʌ z h iː n oʊ j uː ɑː ɹ	does he know you are ?
oʊ k eɪ ð ɛ ɹ ð eɪ ɑː ɹ	okay there they are .
w ʌ t s ɡ oʊ ɪ ŋ ɔ n oʊ v ɚ h ɪ ɹ	what's going on over here ?
d oʊ n t d uː ɪ ɾ oʊ v ɚ ð ɛ ɹ	don't do it over there .
n aʊ j uː w ɔ n ə d uː ɪ t	now you wanna do it .
j uː l aɪ k t ə p ʊ t ɪ t	you like to put it .
w ɛ l h ɪ ɹ j uː ɡ oʊ	well here you go .
j uː k æ n h æ v eɪ	you can have a .
oʊ k eɪ æ n d p ʊ t ð æ t h ɪ ɹ	okay and put that here ?
oʊ k eɪ ɪ z ð æ t ɡ ʊ d	okay is that good ?
n ɑː t ɪ n ɹ aɪ t	not in right ?
j uː d uː l aɪ k ð ə	you do like the .
j ʊ ɹ ɡ ə n ə w ʌ t m iː ʌ p	you're gonna what me up ?
n oʊ aɪ θ ɪ ŋ k j ʊ ɹ ɹ aɪ t	no i think you're right .
ɪ t s ɐ b ɪ ɡ w ʌ n t uː	it's a big one too .
ɪ z ð æ t ɔː l ʌ v ð ɛ m	is that all of them ?
t ə b ɪ ɡ	to big ?
ð æ t b ɪ ɡ w ʌ n	that big one .
w ɛ l w ʌ t s ð ɪ s	well what's this .
j uː d oʊ n t n oʊ ð ɛ m	you don't know them ?
d uː j uː θ ɪ ŋ k ð æ t ʌ m	do you think that um .
ð eɪ ɔː l l aɪ k ð æ t	they all like that .
d uː j uː n oʊ w ʌ t ð ɪ s	do you know what this ?
w ʌ t s ʃ iː ɡ ɑː t w ɪ ð h ɜː	what's she got with her ?
ɑː ɹ j uː	are you ?
s oʊ d uː aɪ	so do i ?
ɡ oʊ t ə ð ə ɹ aɪ t	go to the right ?
ð eɪ t uː b ɪ ɡ	they too big .
h ɪ ɹ k ʌ m s iː m iː	here come see me .
aɪ w ʌ z l aɪ k	i was like .
æ n d l ʊ k ɪ t h ɪ ɹ	and look it here .
oʊ ð æ t s w ʌ t j uː d uː	oh that's what you do .
æ n d aɪ n oʊ	and i know .
p ʊ t ð ɛ m h ɪ ɹ	put them here .
w ɛ ɹ d uː aɪ p ʊ t ɪ t	where do i put it ?
ð ɛ ɹ z ð ə l ɪ ɾ ə l b eɪ b i	there's the little baby .
h ɪ ɹ ɪ z ð ə	here is the .
oʊ k eɪ ɡ ɛ t aʊ t	okay get out !
w ʌ t b eɪ b i	what baby ?
d̠ʒ ʌ s t j uː	just you ?
ʌ v m iː	of me !
ɡ ɑː t w ʌ n ɪ n	got one in .
s eɪ ʌ p	say up !
oʊ n oʊ j uː ɡ ɑː t m iː	oh no you got me .
d ʌ z ʃ iː n oʊ ð æ t	does she know that ?
oʊ j ɛ h ʌ m	oh yeah um .
d oʊ n t j uː w ɔ n ə ɡ oʊ	don't you wanna go ?
b ɪ k ʌ z aɪ w ɔ n t	because i want .
ʌ m j ɛ h	um yeah .
n aʊ aɪ w ʌ t	now i what ?
w ʌ n ɐ w ʌ t	one a what ?
oʊ ð æ t s m aɪ	oh that's my .
w ʌ t h æ v w iː h ɪ ɹ	what have we here ?
w ɛ ɹ ɑː ɹ ð ə	where are the .
ð eɪ ɡ oʊ ɹ aɪ t h ɪ ɹ	they go right here .
s eɪ ð ɛ ɹ h iː ɪ z	say there he is .
w ʌ t w ʌ t w ʌ t	what what what ?
p ʊ t ð æ t ɪ n	put that in .
aɪ m l aɪ k aɪ d oʊ n t n oʊ	i'm like i don't know .
aɪ θ ɪ ŋ k j uː d ɪ d ɪ t	i think you did it .
ð eɪ d̠ʒ ʌ s t d oʊ n t	they just don't .
j uː w ɔ n ə ɡ oʊ ɡ ɛ t ð ɛ m	you wanna go get them ?
s iː h aʊ w iː d uː	see how we do .
ɪ t s ɡ ə n ə b iː ɡ ʊ d	it's gonna be good .
oʊ n ɑː t n aʊ	oh not now .
oʊ ð ə b ɪ ɡ w ʌ n j ɛ h	oh the big one yeah !
n ɑː t t ə ɡ ʊ d	not to good .
w iː k æ n ɔː l p l eɪ	we can all play !
s ʌ m ɑː ɹ n ɑː t	some are not .
k æ n j uː d uː ð ɪ s	can you do this ?
oʊ k eɪ æ n d ð æ t ɪ z ɪ t	okay and that is it .
p ʊ t ɪ ɾ ʌ p ð ɛ ɹ	put it up there !
l ɛ t s s iː j ɛ h	let's see yeah ?
w ɛ l ð æ t s oʊ k eɪ ð æ t s oʊ k eɪ	well that's okay that's okay .
w ɔ n ə ɡ oʊ ɪ n	wanna go in ?
s oʊ ɪ t b iː ɐ w ʌ t	so it be a what ?
d uː j uː w ɔ n ə p ʊ t w ʌ t	do you wanna put what ?
d ɪ d j uː m eɪ k ɪ t	did you make it ?
oʊ w ʌ t s ɡ oʊ ɪ ŋ ɔ n h ɪ ɹ	oh what's going on here .
ð æ t s ɹ aɪ t ʃ iː d ʌ z	that's right she does .
h aʊ d ʌ z ð æ t d uː ð æ t	how does that do that ?
j uː d̠ʒ ʌ s t w ɔ n ə iː t ɪ t	you just wanna eat it ?
d uː j uː w ɔ n ə ɡ ɛ t aʊ t	do you wanna get out ?
oʊ k eɪ s iː j uː ð ɛ n	okay see you then .
ɡ ə n ə m eɪ k ɐ w ʌ t	gonna make a what ?
j uː n oʊ w ʌ t j uː	you know what you .
ɪ t d ʌ z	it does !
w ʌ t s ð ɪ s ʌ p h ɪ ɹ	what's this up here ?
n oʊ ð æ t s ɐ ʌ m	no that's a um .
æ n d ɪ t s ɡ oʊ ɪ ŋ ʌ p	and it's going up .
h aʊ d ɪ d ð æ t ɡ oʊ	how did that go ?
w ʌ t d ʌ z ʃ iː h æ v ɔ n	what does she have on ?
h iː z ɡ oʊ ɪ ŋ t ʊ iː t	he's going to eat .
oʊ h ɪ ɹ h ɪ ɹ	oh here here .
oʊ k eɪ j uː w ɔ n ə ɡ ɛ t aʊ t	okay you wanna get out ?
j uː k æ n oʊ	you can oh .
oʊ l ʊ k æ ɾ ɔː l ð ɪ s	oh look at all this !
l ɛ t s ɡ ɛ t d aʊ n	let's get down .
oʊ aɪ θ ɪ ŋ k ð æ t s ɹ aɪ t	oh i think that's right !
b ɪ k ʌ z ɪ f j ʊ ɹ n ɑː t	because if you're not .
s oʊ ð æ t s	so that's .
ɡ oʊ ɪ n ɹ aɪ t h ɪ ɹ	go in right here !
iː t iː t iː t iː t	eat eat eat eat .
oʊ ɪ t s ɐ ɡ ʊ d w ʌ n	oh it's a good one ?
l aɪ k s oʊ	like so .
w ɪ ð h ɪ m	with him .
oʊ k eɪ l ʊ k æ t ð ɪ s	okay look at this .
h aʊ d uː w iː ɡ ɛ t ɪ t	how do we get it ?
n oʊ p ʊ t ɪ t ɹ aɪ t h ɪ ɹ	no put it right here .
ɪ z ð æ t w ʌ t j uː h æ v	is that what you have ?
n aʊ j uː ɡ ɑː t	now you got .
d̠ʒ ʌ s t j uː	just you .
aɪ d ɪ d l ʊ k ð ɛ ɹ	i did look there .
n aʊ w ʌ t d uː j uː θ ɪ ŋ k	now what do you think ?
n oʊ n ɑː t h ɜː	no not her .
æ n d w ʌ t ɐ b aʊ t h ɪ m	and what about him ?
j ʊ ɹ j ʊ ɹ	your your .
k æ n j uː l ʊ k ɪ n ɪ t	can you look in it ?
j uː w ɔ n ə ɡ ɛ t ɪ t	you wanna get it ?
ʃ iː d oʊ n t w ɔ n ə ɡ oʊ	she don't wanna go !
ɹ aɪ t æ n d w ʌ t s ð ɪ s	right and what's this ?
ð æ t s w ʌ n ʌ v ð ɛ m	that's one of them .
j uː d uː	you do .
s oʊ w ʌ t h æ v j uː	so what have you ?
n aʊ ʌ m d aʊ n h ɪ ɹ	now um down here ?
j uː d ɪ d	you did !
n ɑː t m iː n ɑː t j uː	not me not you .
h aʊ ɐ b aʊ t l ɪ ɾ ə l w ʌ n	how about little one ?
s oʊ ð ɛ ɹ	so there .
ɔː ɹ w iː h æ v eɪ	or we have a .
æ n d w ʌ t ɪ z æ t	and what is at ?
w ɛ l p ʊ t ð ɛ m ɪ n	well put them in .
oʊ w ʌ t w ʌ z ð æ t	oh what was that .
w ʌ t d ʌ z ʃ iː w ɔ n ə d uː	what does she wanna do ?
b ɪ k ʌ z w iː l aɪ k ɪ t t uː	because we like it too .
æ n d æ n d j uː s iː ʃ iː	and and you see she .
j uː ɡ ə n ə ɡ oʊ	you gonna go ?
w ɛ l oʊ k eɪ l ɛ t s s iː j uː	well okay let's see you .
h ɪ ɹ aɪ θ ɪ ŋ k	here i think .
j ɛ h æ n d j uː l aɪ k ɪ t	yeah and you like it ?
oʊ k eɪ k ʌ m ɔ n	okay come on .
l ʊ k w ʌ t s ɪ n h ɪ ɹ	look what's in here !
s iː s iː ð æ t	see see that ?
ʌ m j ɛ h aɪ d oʊ n t n oʊ	um yeah i don't know .
ɹ aɪ t oʊ v ɚ h ɪ ɹ ɑː ɹ s ʌ m	right over here are some .
k æ n j uː s eɪ b eɪ b i	can you say baby ?
oʊ h aʊ ɐ b aʊ t h ɪ ɹ	oh how about here ?
ɔː l ð ɪ s w ʌ z ɐ b aʊ t	all this was about .
ɡ oʊ ɔ n iː t	go on eat .
p ʊ t ð ə b eɪ b i d aʊ n	put the baby down .
aɪ m ɡ ə n ə b iː	i'm gonna be .
w ʌ t s ð ɪ s	what's this .
s oʊ k æ n aɪ k ʌ m	so can i come ?
n aʊ d uː ɪ t ɹ aɪ t	now do it right .
j uː ɡ oʊ ɪ ŋ t ʊ iː t ð ɪ s	you going to eat this ?
oʊ l ʊ k h ɪ ɹ	oh look here !
j ɛ h n ɑː t w ʌ n	yeah not one .
ɪ t s n oʊ	it's no .
oʊ k eɪ w ʌ t s ɪ n h ɪ ɹ	okay what's in here ?
w ʌ t ɐ b aʊ t h ɜː	what about her ?
w ɔ n ə ɡ oʊ oʊ v ɚ ð ɛ ɹ	wanna go over there ?
ɪ t s ɪ n m aɪ h ɪ ɹ	it's in my here .
aʊ t h ɪ ɹ h ɪ ɹ	out here here .
oʊ k eɪ ð æ t s ɡ ʊ d	okay that's good !
w ʌ t k æ n w iː d uː ð ɛ n	what can we do then ?
w iː d oʊ n t p l eɪ w ɪ ð ð æ t	we don't play with that .
h aʊ ɐ b aʊ t j uː k æ n j uː	how about you can you .
d oʊ n t w iː n oʊ	don't we know ?
oʊ j uː l aɪ k ð æ t	oh you like that ?
j ɛ h w ɛ l aɪ	yeah well i .
w ʌ t ɑː ɹ h ɪ ɹ	what are here ?
ð ɛ ɹ z eɪ	there's a .
w ɔ n ə p ʊ t ð æ t ɔ n m iː	wanna put that on me ?
d oʊ n t ɡ oʊ d aʊ n	don't go down ?
j ɛ h j ʊ ɹ oʊ k eɪ	yeah you're okay .
w iː d̠ʒ ʌ s t h æ v w ɛ l	we just have well .
l ɛ t s s iː j uː	let's see you .
d oʊ n t p ʊ t ɪ ɾ ɔ n	don't put it on .
oʊ ð ɪ s ɔː l ɡ oʊ ɪ ŋ	oh this all going .
ɡ ʊ d b ɪ k ʌ z aɪ d oʊ n t	good because i don't .
oʊ ð æ t w ʌ z ɡ ʊ d w ʌ t	oh that was good what .
ð æ t s ɔː l j uː w ɔ n ə d uː	that's all you wanna do ?
j ɛ h æ n d w ʌ t s ɔː l ð ɪ s	yeah and what's all this ?
l ɛ t s d uː p l eɪ	let's do play .
aɪ l aɪ k ð æ t aɪ d uː	i like that i do .
w ɛ n ɑː ɹ j uː ɡ oʊ ɪ ŋ	when are you going ?
oʊ k eɪ ð ɪ s	okay this .
n aʊ n oʊ	now no .
w ʌ t d ɪ d w iː h æ v	what did we have ?
n aʊ p ʊ t ɪ ɾ ɪ n	now put it in .
d ɪ d j uː s iː ð æ t	did you see that ?
n oʊ n aʊ	no now !
j ɛ h l ɛ t s n ɑː t oʊ k eɪ	yeah let's not okay .
l ʊ k æ t l ʊ k æ t	look at look at .
j uː ɡ ə n ə ɡ oʊ ɡ oʊ ɡ oʊ	you gonna go go go ?
oʊ n aʊ w ʌ t s ð ɪ s	oh now what's this ?
h ɪ ɹ ʃ iː ɪ z	here she is !
h ɪ ɹ ɡ ɛ t ɪ t	here get it .
b eɪ b i k æ n ɡ oʊ ɪ n ð ɛ ɹ	baby can go in there .
d ɪ d aɪ ɡ ɛ t ɪ t	did i get it ?
æ n d l ɛ t s s iː h ɪ ɹ	and let's see here .
j uː iː t w ʌ t j uː ɡ ɑː t	you eat what you got .
j uː k æ n k ʌ m aʊ t	you can come out .
ð æ t j uː t uː b ɪ ɡ	that you too big ?
oʊ k eɪ k ʌ m ɔ n d aʊ n	okay come on down .
aʊ t w ɛ ɹ	out where ?
aɪ d uː ð æ t	i do that .
s iː ɪ f j uː l aɪ k ɪ t	see if you like it .
w ɛ l w ɛ ɹ ɪ z ð ɪ s	well where is this .
ɑː ɹ ð eɪ ɡ ə n ə b iː oʊ k eɪ	are they gonna be okay ?
ɔː ɹ n oʊ	or no ?
oʊ h iː z	oh he's .
æ n d n oʊ ð æ t s ɐ b aʊ t ɪ t	and no that's about it .
oʊ ð æ t s ɐ ɡ ʊ d w ʌ n	oh that's a good one .
j uː l aɪ k ð ɪ eɪ	you like the a ?
d oʊ n t j uː θ ɪ ŋ k	don't you think .
ð ə l ɪ ɾ ə l w ʌ t	the little what ?
oʊ k eɪ ʌ m oʊ k eɪ	okay um okay .
n oʊ ɹ aɪ t	no right ?
l aɪ k ð ɪ s æ n d l aɪ k ð ɪ s	like this and like this .
h ɪ ɹ w iː k ʌ m	here we come !
j ɛ h j uː d ɪ d	yeah you did .
ð ɪ s ɪ z n ɑː t f ɔː ɹ j uː	this is not for you .
j ʊ ɹ aɪ d oʊ n t n oʊ	you're i don't know .
aɪ iː t ɪ t	i eat it .
ð ɪ s w iː d oʊ n t h æ v	this we don't have .
d uː j uː w ɔ n t ɪ t	do you want it ?
h ɪ ɹ l ʊ k l ʊ k	here look look !
l ɛ t s s iː ð æ t n aʊ	let's see that now .
s oʊ w ʌ t s ɡ oʊ ɪ ŋ ɔ n h ɪ ɹ	so what's going on here ?
s iː ð æ t s	see that's .
w iː ɑː ɹ	we are ?
æ n d w ʌ t d ʌ z ð æ t s eɪ	and what does that say ?
d ʌ z ð æ t l ʊ k ɡ ʊ d	does that look good ?
ʌ p h ɪ ɹ ð ɛ ɹ z w ʌ n	up here there's one .
h aʊ d uː aɪ d uː ɪ t	how do i do it ?
ɹ aɪ t oʊ l ʊ k ɐ ð ɛ ɹ	right oh look a there .
ð æ t s w ʌ t j uː	that's what you .
æ n d aɪ h æ v	and i have .
aʊ t ð æ t	out that .
l aɪ k ð ɪ s ɔː ɹ l aɪ k ð ɪ s	like this or like this ?
oʊ j uː l aɪ k ð æ t b eɪ b i	oh you like that baby ?
n oʊ h iː ɪ z	no he is .
aɪ m n ɑː t	i'm not ?
d oʊ n t w ɔ n ə p l eɪ w ɪ ð m iː	don't wanna play with me ?
aɪ h æ v ð ɛ m ɹ aɪ t h ɪ ɹ	i have them right here .
aɪ s eɪ ʌ v	i say of .
n aʊ l ʊ k æ t h ɪ m	now look at him .
k ʌ m ɡ ɛ t ð ɛ m	come get them !
ʌ m aɪ k æ n	um i can .
d uː j uː w ɔ n ə s iː ð ɪ s	do you wanna see this ?
aɪ w ɔ n ə p l eɪ w ɪ ð ɪ t	i wanna play with it .
d uː j uː n oʊ h aʊ	do you know how .
oʊ ɑː ɹ w iː ɡ oʊ ɪ ŋ	oh are we going ?
n aʊ aɪ m ɡ ə n ə d uː	now i'm gonna do .
ɪ f j uː k æ n d uː ð æ t	if you can do that .
ɪ z ɪ ɾ ɐ w ʌ t	is it a what ?
j uː θ ɪ ŋ k aɪ d ɪ d	you think i did ?
oʊ b eɪ b i	oh baby .
n aʊ aɪ d ɪ d	now i did .
oʊ aɪ ɡ ɑː t ɪ ɾ ɔ n	oh i got it on .
aɪ w ɔ n t s ʌ m	i want some !
s oʊ ð ɪ ʌ m	so the um .
b ɪ k ʌ z l ʊ k w ʌ t aɪ h æ v	because look what i have !
d uː j uː w ɔ n ə p l eɪ ð æ t	do you wanna play that ?
l ɛ t s s iː h aʊ j uː d uː	let's see how you do .
j uː iː t w ʌ n	you eat one .
oʊ j uː ɑː ɹ s oʊ ɡ ʊ d	oh you are so good .
h aʊ ɐ b aʊ t ɔ n ð ɛ ɹ	how about on there ?
w ɛ l k ʌ m ɔ n ð ɛ n	well come on then .
s iː w ʌ t w iː ɡ ɑː t	see what we got .
n oʊ d oʊ n t p ʊ t	no don't put !
w ɛ l p ʊ t ð æ t ɪ n ð ɛ ɹ	well put that in there .
ɔ n j uː	on you ?
h ɪ ɹ k ʌ m k ʌ m	here come come .
j uː d oʊ n t s eɪ b ɪ k ʌ z	you don't say because .
j uː d oʊ n t	you don't .
d ɪ d w iː d̠ʒ ʌ s t d uː ð æ t	did we just do that ?
ð æ t s ð æ t s ɔː l	that's that's all .
b ɪ k ʌ z ɪ t w ʌ z ɪ n ð ɛ ɹ	because it was in there .
ɔː l ɹ aɪ t ɔː l ɹ aɪ t	all right all right .
aɪ w ɔ n t ð ɛ m ʌ p	i want them up !
æ n d l ʊ k h aʊ ʃ iː ɪ z	and look how she is .
θ ɪ ŋ k j uː l aɪ k ð æ t	think you like that ?
oʊ j ɛ h h ɪ ɹ ɪ ɾ ɪ z	oh yeah here it is .
h aʊ b ɪ ɡ ɪ z b eɪ b i	how big is baby .
oʊ j uː ɡ ɑː t w ʌ n	oh you got one ?
l ʊ k ɪ z ɹ aɪ t	look is right .
j uː ɡ ə n ə p l eɪ w ɪ ð ɪ t	you gonna play with it ?
h ɪ ɹ j uː ɡ oʊ ʌ p	here you go up .
d aʊ n d aʊ n ɹ aɪ t	down down right .
n aʊ h iː z	now he's .
æ n d n oʊ ð æ t s ɐ b aʊ t ɔː l	and no that's about all .
ɡ oʊ n aʊ	go now ?
h iː z ɡ ə n ə w ʌ t	he's gonna what ?
d uː j uː w ɔ n ə	do you wanna ?
s iː w ʌ t d aʊ n ɪ n ð ɛ ɹ	see what down in there ?
d ɪ d j uː d uː ð ɪ s	did you do this ?
l ʊ k æ t h ɪ m d uː ɪ t	look at him do it !
aɪ w ɔ n ə k ʌ m aʊ t	i wanna come out !
h ɪ ɹ ɹ aɪ t oʊ v ɚ h ɪ ɹ	here right over here .
j uː d oʊ n t l aɪ k d̠ʒ ʌ s t m iː	you don't like just me ?
oʊ k eɪ h aʊ d uː j uː m eɪ k	okay how do you make .
n oʊ j ʊ ɹ ɹ aɪ t j ʊ ɹ ɹ aɪ t	no you're right you're right .
æ n d ð eɪ l ʊ k l aɪ k ð æ t	and they look like that .
k æ n j uː p ʊ t h ɪ m ɪ n	can you put him in ?
ʌ m ð æ t s ɡ ʊ d	um that's good !
æ n d æ n d æ n d æ n d	and and and and .
ɔː ɹ w ʌ t ɪ f	or what if .
oʊ aɪ l aɪ k ɪ t	oh i like it .
aɪ θ ɪ ŋ k ɪ t s t uː b ɪ ɡ	i think it's too big .
ɔː ɹ ð ə n ɑː t s oʊ	or the not so .
w ɛ l w ʌ t d ɪ d h iː s eɪ	well what did he say ?
n aʊ l ɛ t s ɡ oʊ h ɪ ɹ	now let's go here .
d oʊ n t oʊ	don't oh !
w ɛ l w ʌ t s h iː d uː	well what's he do ?
d ɪ d h iː l aɪ k j uː	did he like you ?
ɪ z ɔː l oʊ v ɚ j uː	is all over you .
n oʊ h aʊ	no how !
oʊ n oʊ w ʌ t ɪ z ð ɪ s	oh no what is this ?
j ɛ h j uː d uː d oʊ n t j uː	yeah you do don't you ?
n oʊ n ɑː t l aɪ k ð æ t	no not like that .
oʊ j ɛ h w ʌ t s ð æ t	oh yeah what's that ?
k æ n j uː iː t l aɪ k ð æ t	can you eat like that ?
ð ɛ n ɡ ɛ t ʌ p	then get up .
oʊ j uː ɡ ɑː t ð ɛ m ɔː l	oh you got them all ?
b ʌ t aɪ	but i .
d ɪ d ɪ t ɡ oʊ d aʊ n h ɪ ɹ	did it go down here ?
d ʌ z ɪ t	does it ?
j uː ɡ oʊ ɪ n ɪ t	you go in it .
ɪ z ð æ t h ɪ z	is that his .
w ʌ t s ɪ n ð æ t	what's in that ?
n aʊ l ɛ t s l ʊ k h ɪ ɹ	now let's look here .
oʊ ð ɪ s ɪ z m aɪ b eɪ b i	oh this is my baby .
aɪ w ɔ n t ð ə l ɪ ɾ ə l w ʌ n	i want the little one ?
ɹ aɪ t h ɪ ɹ h aʊ ɐ b aʊ t h ɪ ɹ	right here how about here ?
d uː j uː l ʊ k	do you look !
d uː j uː w ɔ n ə ɡ oʊ p l eɪ	do you wanna go play ?
w ɛ l w ʌ t d uː j uː s eɪ	well what do you say ?
oʊ ð æ t ɪ z n ɑː t ɡ ʊ d	oh that is not good .
ð ɛ ɹ w iː ɡ oʊ n aʊ s iː	there we go now see ?
j uː k æ n ɡ oʊ d aʊ n ð ɛ ɹ	you can go down there .
w ʌ t ɪ z ð ɪ s eɪ	what is this a .
aɪ d oʊ n t θ ɪ ŋ k ð eɪ k æ n	i don't think they can .
w ɔ n ə p ʊ t s ʌ m ɔ n	wanna put some on ?
n ɑː t aʊ t ɪ n	not out in .
ð æ t s oʊ v ɚ n aʊ	that's over now .
ð æ t s w ʌ t ɪ t s ɔː l ɐ b aʊ t	that's what it's all about .
j ɛ h n aʊ aɪ s iː ð ɛ m	yeah now i see them .
w ɛ l j uː d uː	well you do ?
aɪ s iː ð ɛ m	i see them !
w ʌ t w ʌ t s w ʌ t b eɪ b i	what what's what baby ?
aɪ p ʊ t ð ɛ m ɔ n	i put them on .
oʊ n oʊ n ɑː t h ɪ m	oh no not him .
ð ɛ ɹ ɡ ɑː t ɪ t	there got it ?
j ɛ h b ʌ t ð ɛ n	yeah but then .
w ʌ t w ʌ t s ð ɪ s	what what's this ?
s oʊ ɪ t w ʌ z j uː n oʊ	so it was you know .
oʊ k eɪ p ʊ t ð ɛ m d aʊ n n aʊ	okay put them down now .
w ɛ l d uː j uː w ɔ n ə ɡ oʊ	well do you wanna go ?
w ʌ t d uː j uː w ɔ n ə s iː	what do you wanna see .
l ɛ t s l ʊ k w ʌ t s ɪ n h ɪ ɹ	let's look what's in here .
j uː ɡ ɛ t d aʊ n	you get down .
j ʊ ɹ n ɑː t ɡ oʊ ɪ ŋ t ə b iː	you're not going to be ?
ð ɛ ɹ h iː ɪ z	there he is .
æ n d j uː p ʊ t ð ə	and you put the .
j uː s iː w ʌ n h ɪ ɹ	you see one here .
ð æ t s w ɛ ɹ ð ə s iː ð æ t	that's where the see that .
n oʊ w ɛ l w iː d oʊ n t n oʊ	no well we don't know .
oʊ n oʊ h ɪ ɹ	oh no here .
w iː k æ n d uː ð æ t	we can do that !
h iː z ɪ n	he's in .
aɪ m ɡ ə n ə ɡ ɛ t j uː aʊ t	i'm gonna get you out .
w ɪ ð eɪ	with a .
ʌ m ɪ z	um is .
h æ v s ʌ m w ʌ t	have some what ?
aɪ d̠ʒ ʌ s t p ʊ t ð æ t ð ɛ ɹ	i just put that there .
ð eɪ ɑː ɹ ɔː l ɪ n	they are all in .
w ɛ l ɡ ɛ t d aʊ n ð ɛ ɹ	well get down there .
oʊ k eɪ ɡ oʊ	okay go .
æ n d w ʌ n ɹ aɪ t ð ɛ ɹ	and one right there .
w ɔ n ə ɡ oʊ s iː	wanna go see ?
w ʌ t w ʌ z ð æ t	what was that ?
j ɛ h j ɛ h ð æ t s oʊ k eɪ	yeah yeah that's okay .
ɑː ɹ j uː ɡ oʊ ɪ ŋ eɪ	are you going a .
ɪ f ɪ f j uː w ɔ n t t uː	if if you want to .
j uː n oʊ w ʌ t ð eɪ h æ v	you know what they have ?
d oʊ n t m eɪ k ɪ ɾ ʌ p	don't make it up .
b eɪ b i t ə k ʌ m h ɪ ɹ	baby to come here .
l ɛ t s s iː w ʌ t w iː h æ v	let's see what we have .
